Year,State Name,Total population,Number of Male,Percent of Male,Number of Female,Percent of Female,Number of 18 years and over,Percent of 18 years and over,Number Male 18 and over,Percent Male 18 and over,Number Female 18 and over,Percent Female 18 and over,Number Two or more races,Percent Two or more races,Number One race,Percent One race,Number of White,Percent of White,Number of Black or African American,Percent of Black or African American,Number of American Indian and Alaska Native,Percent of American Indian and Alaska Native,Number of Asian,Percent of Asian,Number of Native Hawaiian and Other Pacific Islander,Percent of Native Hawaiian and Other Pacific Islander,Other races,Percent Other race
2010,Alabama,4785298,2322243,48.5,2463055,51.5,3649870,3649870,1740071,47.7,1909799,52.3,65186,1.4,4720112,98.6,3382838,70.7,1290667,27,56024,1.2,64811,1.4,2500,0.1,56447,1.2
2010,Alaska,713985,372436,52.2,341549,47.8,525600,525600,274121,52.2,251479,47.8,50037,7,663948,93,526642,73.8,33121,4.6,137943,19.3,50131,7,12315,1.7,9173,1.3
2010,Arizona,6413737,3190700,49.7,3223037,50.3,4781326,4781326,2353852,49.2,2427474,50.8,169557,2.6,6244180,97.4,5242273,81.7,312920,4.9,333890,5.2,227244,3.5,23994,0.4,454796,7.1
2010,Arkansas,2921606,1430837,49,1490769,51,2210476,2210476,1069304,48.4,1141172,51.6,49157,1.7,2872449,98.3,2336002,80,480407,16.4,42959,1.5,38999,1.3,7764,0.3,67397,2.3
2010,California,37349363,18570505,49.7,18778858,50.3,28042134,28042134,13804975,49.2,14237159,50.8,1568280,4.2,35781083,95.8,24611291,65.9,2649422,7.1,670960,1.8,5540174,14.8,289873,0.8,5301856,14.2
2010,Colorado,5049071,2531362,50.1,2517709,49.9,3820393,3820393,1899660,49.7,1920733,50.3,172237,3.4,4876834,96.6,4359904,86.4,247808,4.9,108671,2.2,190340,3.8,16697,0.3,317772,6.3
2010,Connecticut,3577073,1738918,48.6,1838155,51.4,2761785,2761785,1322574,47.9,1439211,52.1,90987,2.5,3486086,97.5,2872261,80.3,402971,11.3,29836,0.8,155442,4.3,2609,0.1,212833,5.9
2010,Delaware,899769,436608,48.5,463161,51.5,693700,693700,331102,47.7,362598,52.3,23096,2.6,876673,97.4,654859,72.8,203620,22.6,8641,1,33185,3.7,1794,0.2,21762,2.4
2010,Florida,18843326,9212548,48.9,9630778,51.1,14843807,14843807,7163850,48.3,7679957,51.7,406999,2.2,18436327,97.8,14743216,78.2,3195360,17,157703,0.8,564551,3,34031,0.2,587749,3.1
2010,Georgia,9712587,4742754,48.8,4969833,51.2,7218066,7218066,3465631,48,3752435,52,178891,1.8,9533696,98.2,6036648,62.2,3071510,31.6,71422,0.7,359802,3.7,8984,0.1,356253,3.7
2010,Hawaii,1363621,684087,50.2,679534,49.8,1059960,1059960,527069,49.7,532891,50.3,324109,23.8,1039512,76.2,573468,42.1,40443,3,39695,2.9,784873,57.6,347511,25.5,36113,2.6
2010,Idaho,1571450,787506,50.1,783944,49.9,1142490,1142490,566293,49.6,576197,50.4,36593,2.3,1534857,97.7,1483490,94.4,14178,0.9,38506,2.5,28334,1.8,5760,0.4,41160,2.6
2010,Illinois,12843166,6294434,49,6548732,51,9717236,9717236,4696320,48.3,5020916,51.7,242619,1.9,12600547,98.1,9518017,74.1,1968117,15.3,82449,0.6,662800,5.2,13494,0.1,855701,6.7
2010,Indiana,6490621,3197124,49.3,3293497,50.7,4884506,4884506,2372252,48.6,2512254,51.4,128676,2,6361945,98,5638618,86.9,655352,10.1,54413,0.8,124878,1.9,2800,0,149955,2.3
2010,Iowa,3049883,1505879,49.4,1544004,50.6,2325209,2325209,1137011,48.9,1188198,51.1,55301,1.8,2994582,98.2,2842892,93.2,119355,3.9,27622,0.9,62609,2.1,3193,0.1,54016,1.8
2010,Kansas,2859169,1417134,49.6,1442035,50.4,2132343,2132343,1044557,49,1087786,51,89392,3.1,2769777,96.9,2515800,88,204390,7.1,65298,2.3,84758,3,2772,0.1,83039,2.9
2010,Kentucky,4346266,2140493,49.2,2205773,50.8,3324930,3324930,1612126,48.5,1712804,51.5,71454,1.6,4274812,98.4,3903375,89.8,375434,8.6,32528,0.7,59038,1.4,4203,0.1,48757,1.1
2010,Louisiana,4544228,2227014,49,2317214,51,3426176,3426176,1653635,48.3,1772541,51.7,69766,1.5,4474462,98.5,2916456,64.2,1489050,32.8,54590,1.2,82904,1.8,8085,0.2,68906,1.5
2010,Maine,1327567,648889,48.9,678678,51.1,1053916,1053916,508023,48.2,545893,51.8,23570,1.8,1303997,98.2,1286799,96.9,20964,1.6,20404,1.5,18373,1.4,1985,0.1,3606,0.3
2010,Maryland,5785982,2799597,48.4,2986385,51.6,4434210,4434210,2109076,47.6,2325134,52.4,159899,2.8,5626083,97.2,3536519,61.1,1787319,30.9,56860,1,372885,6.4,8075,0.1,200293,3.5
2010,Massachusetts,6557254,3170167,48.3,3387087,51.7,5140133,5140133,2446687,47.6,2693446,52.4,180734,2.8,6376520,97.2,5474313,83.5,543824,8.3,43634,0.7,395454,6,7959,0.1,281449,4.3
2010,Michigan,9877574,4848760,49.1,5028814,50.9,7542667,7542667,3651822,48.4,3890845,51.6,241792,2.4,9635782,97.6,8044962,81.4,1505954,15.2,141557,1.4,287843,2.9,8455,0.1,149427,1.5
2010,Minnesota,5310584,2635397,49.6,2675187,50.4,4026931,4026931,1977935,49.1,2048996,50.9,127859,2.4,5182725,97.6,4686982,88.3,331444,6.2,100678,1.9,245411,4.6,7220,0.1,77105,1.5
2010,Mississippi,2970036,1441525,48.5,1528511,51.5,2216868,2216868,1057681,47.7,1159187,52.3,31832,1.1,2938204,98.9,1796181,60.5,1124460,37.9,26205,0.9,30479,1,499,0,25899,0.9
2010,Missouri,5996231,2932383,48.9,3063848,51.1,4578660,4578660,2206937,48.2,2371723,51.8,132531,2.2,5863700,97.8,5103564,85.1,755625,12.6,79319,1.3,120161,2,8498,0.1,68489,1.1
2010,Montana,990898,499235,50.4,491663,49.6,768298,768298,383223,49.9,385075,50.1,23883,2.4,967015,97.6,913685,92.2,7875,0.8,78095,7.9,9940,1,2096,0.2,5290,0.5
2010,Nebraska,1830429,906540,49.5,923889,50.5,1370063,1370063,671548,49,698515,51,40109,2.2,1790320,97.8,1659972,90.7,99261,5.4,34946,1.9,38015,2.1,3516,0.2,40129,2.2
2010,Nevada,2704642,1365498,50.5,1339144,49.5,2039869,2039869,1025037,50.3,1014832,49.7,105118,3.9,2599524,96.1,2055140,76,247972,9.2,50383,1.9,243233,9,35600,1.3,191426,7.1
2010,New Hampshire,1316759,647349,49.2,669410,50.8,1030995,1030995,501879,48.7,529116,51.3,21147,1.6,1295612,98.4,1257465,95.5,21817,1.7,11099,0.8,34435,2.6,1209,0.1,12755,1
2010,New Jersey,8801624,4284049,48.7,4517575,51.3,6738812,6738812,3229289,47.9,3509523,52.1,229312,2.6,8572312,97.4,6278395,71.3,1293921,14.7,64395,0.7,794442,9,11292,0.1,602956,6.9
2010,New Mexico,2065932,1020996,49.4,1044936,50.6,1547286,1547286,757021,48.9,790265,51.1,59222,2.9,2006710,97.1,1567232,75.9,54593,2.6,215349,10.4,36328,1.8,2855,0.1,252410,12.2
2010,New York,19392283,9387534,48.4,10004749,51.6,15079820,15079820,7180714,47.6,7899106,52.4,513388,2.6,18878895,97.4,13159790,67.9,3272124,16.9,178497,0.9,1579797,8.1,23391,0.1,1734163,8.9
2010,North Carolina,9561558,4657156,48.7,4904402,51.3,7277315,7277315,3484463,47.9,3792852,52.1,218757,2.3,9342801,97.7,6844118,71.6,2163190,22.6,196819,2.1,252755,2.6,10942,0.1,334771,3.5
2010,North Dakota,674499,343445,50.9,331054,49.1,524042,524042,264209,50.4,259833,49.6,13775,2,660724,98,619740,91.9,10639,1.6,42100,6.2,10260,1.5,1544,0.2,4987,0.7
2010,Ohio,11536182,5630118,48.8,5906064,51.2,8815336,8815336,4241381,48.1,4573955,51.9,240569,2.1,11295613,97.9,9788114,84.8,1555034,13.5,86303,0.7,239994,2.1,8717,0.1,120251,1
2010,Oklahoma,3761702,1856245,49.3,1905457,50.7,2830778,2830778,1382995,48.9,1447783,51.1,297782,7.9,3463920,92.1,3037556,80.7,325386,8.6,500686,13.3,81999,2.2,9384,0.2,115051,3.1
2010,Oregon,3838957,1902185,49.5,1936772,50.5,2972446,2972446,1455217,49,1517229,51,137964,3.6,3700993,96.4,3387267,88.2,97227,2.5,108995,2.8,186304,4.9,25816,0.7,183046,4.8
2010,Pennsylvania,12709630,6192105,48.7,6517525,51.3,9924456,9924456,4766161,48,5158295,52,239065,1.9,12470565,98.1,10692745,84.1,1514969,11.9,76809,0.6,399176,3.1,12085,0.1,269952,2.1
2010,Puerto Rico,3722133,1785266,48,1936867,52,2824489,2824489,1323258,46.8,1501231,53.2,497879,13.4,3224254,86.6,3012841,80.9,762659,20.5,17864,0.5,15598,0.4,555,0,422436,11.3
2010,Rhode Island,1052886,508198,48.3,544688,51.7,828863,828863,393233,47.4,435630,52.6,28928,2.7,1023958,97.3,879768,83.6,77420,7.4,12724,1.2,36668,3.5,2073,0.2,76048,7.2
2010,South Carolina,4636312,2253035,48.6,2383277,51.4,3554882,3554882,1705256,48,1849626,52,84424,1.8,4551888,98.2,3183859,68.7,1345154,29,39255,0.8,73492,1.6,4685,0.1,80665,1.7
2010,South Dakota,816463,411170,50.4,405293,49.6,614383,614383,305388,49.7,308995,50.3,16096,2,800367,98,716434,87.7,13922,1.7,84460,10.3,10717,1.3,408,0,7769,1
2010,Tennessee,6356897,3095030,48.7,3261867,51.3,4859663,4859663,2328962,47.9,2530701,52.1,107997,1.7,6248900,98.3,5079389,79.9,1117185,17.6,55263,0.9,112377,1.8,4076,0.1,103396,1.6
2010,Texas,25257114,12531720,49.6,12725394,50.4,18369567,18369567,9005720,49,9363847,51,548048,2.2,24709066,97.8,19191255,76,3159265,12.5,279613,1.1,1103096,4.4,37998,0.2,2069703,8.2
2010,Utah,2776469,1397849,50.3,1378620,49.7,1902793,1902793,946012,49.7,956781,50.3,65490,2.4,2710979,97.6,2526041,91,40045,1.4,49935,1.8,75415,2.7,38044,1.4,116445,4.2
2010,Vermont,625960,308172,49.2,317788,50.8,496299,496299,241229,48.6,255070,51.4,10315,1.6,615645,98.4,607394,97,9795,1.6,5403,0.9,10856,1.7,766,0.1,2654,0.4
2010,Virginia,8024617,3941957,49.1,4082660,50.9,6170996,6170996,2989464,48.4,3181532,51.6,219298,2.7,7805319,97.3,5755827,71.7,1671545,20.8,69431,0.9,521880,6.5,20609,0.3,223548,2.8
2010,Washington,6744496,3358423,49.8,3386073,50.2,5160913,5160913,2546980,49.4,2613933,50.6,303255,4.5,6441241,95.5,5573501,82.6,325148,4.8,198292,2.9,605031,9,71049,1.1,307132,4.6
2010,West Virginia,1853973,913160,49.3,940813,50.7,1467290,1467290,714602,48.7,752688,51.3,36159,2,1817814,98,1774445,95.7,73610,4,22063,1.2,14155,0.8,2261,0.1,7250,0.4
2010,Wisconsin,5691047,2826199,49.7,2864848,50.3,4354839,4354839,2141846,49.2,2212993,50.8,120805,2.1,5570242,97.9,5059247,88.9,399951,7,94801,1.7,155271,2.7,4000,0.1,108648,1.9
2010,Wyoming,564460,287053,50.9,277407,49.1,427742,427742,217259,50.8,210483,49.2,15118,2.7,549342,97.3,527926,93.5,6729,1.2,23864,4.2,5164,0.9,760,0.1,15279,2.7
2011,Alabama,4802740,2324413,48.4,2478327,51.6,3678352,3678352,1753623,47.7,1924729,52.3,64450,1.3,4738290,98.7,3373539,70.2,1307900,27.2,54540,1.1,66678,1.4,3782,0.1,65584,1.4
2011,Alaska,722718,372916,51.6,349802,48.4,534495,534495,277149,51.9,257346,48.1,60229,8.3,662489,91.7,533690,73.8,36376,5,142478,19.7,50181,6.9,11533,1.6,11999,1.7
2011,Arizona,6482505,3228514,49.8,3253991,50.2,4858481,4858481,2396824,49.3,2461657,50.7,194293,3,6288212,97,5308097,81.9,323562,5,346380,5.3,235750,3.6,22939,0.4,455685,7
2011,Arkansas,2937979,1447850,49.3,1490129,50.7,2226793,2226793,1080057,48.5,1146736,51.5,57229,1.9,2880750,98.1,2348406,79.9,482548,16.4,46716,1.6,42799,1.5,8588,0.3,68877,2.3
2011,California,37691912,18750692,49.7,18941220,50.3,28424476,28424476,14006329,49.3,14418147,50.7,1594007,4.2,36097905,95.8,25002505,66.3,2664982,7.1,689320,1.8,5643693,15,294022,0.8,5140866,13.6
2011,Colorado,5116796,2569136,50.2,2547660,49.8,3888219,3888219,1937510,49.8,1950709,50.2,172773,3.4,4944023,96.6,4469887,87.4,253679,5,115554,2.3,190263,3.7,15931,0.3,259731,5.1
2011,Connecticut,3580709,1743795,48.7,1836914,51.3,2777089,2777089,1332483,48,1444606,52,88584,2.5,3492125,97.5,2859030,79.8,405539,11.3,28406,0.8,160494,4.5,4812,0.1,218739,6.1
2011,Delaware,907135,439918,48.5,467217,51.5,702510,702510,335335,47.7,367175,52.3,24128,2.7,883007,97.3,657018,72.4,209592,23.1,8870,1,34388,3.8,149,0,22386,2.5
2011,Florida,19057542,9321149,48.9,9736393,51.1,15062592,15062592,7275850,48.3,7786742,51.7,423481,2.2,18634061,97.8,14884076,78.1,3245366,17,155194,0.8,585292,3.1,32476,0.2,607438,3.2
2011,Georgia,9815210,4808996,49,5006214,51,7327141,7327141,3527814,48.1,3799327,51.9,190234,1.9,9624976,98.1,6117189,62.3,3126838,31.9,72382,0.7,376258,3.8,12052,0.1,316898,3.2
2011,Hawaii,1374810,688600,50.1,686210,49.9,1070453,1070453,533483,49.8,536970,50.2,331552,24.1,1043258,75.9,589821,42.9,43051,3.1,30102,2.2,784550,57.1,357724,26,36429,2.6
2011,Idaho,1584985,794914,50.2,790071,49.8,1157332,1157332,575003,49.7,582329,50.3,39460,2.5,1545525,97.5,1503412,94.9,17611,1.1,36962,2.3,31722,2,2647,0.2,34452,2.2
2011,Illinois,12869259,6309308,49,6559951,51,9772719,9772719,4731623,48.4,5041096,51.6,263559,2,12605700,98,9550577,74.2,1981146,15.4,83458,0.6,681165,5.3,10326,0.1,842991,6.6
2011,Indiana,6516922,3206430,49.2,3310492,50.8,4919665,4919665,2390114,48.6,2529551,51.4,142369,2.2,6374553,97.8,5643266,86.6,658003,10.1,55375,0.8,127692,2,3913,0.1,178956,2.7
2011,Iowa,3062309,1512251,49.4,1550058,50.6,2338453,2338453,1144355,48.9,1194098,51.1,60888,2,3001421,98,2857920,93.3,115008,3.8,35061,1.1,66595,2.2,3180,0.1,50241,1.6
2011,Kansas,2871238,1423188,49.6,1448050,50.4,2148825,2148825,1053094,49,1095731,51,96539,3.4,2774699,96.6,2529665,88.1,207083,7.2,65739,2.3,84969,3,5081,0.2,82775,2.9
2011,Kentucky,4369356,2143745,49.1,2225611,50.9,3344357,3344357,1620165,48.4,1724192,51.6,80247,1.8,4289109,98.2,3911017,89.5,396429,9.1,31992,0.7,63757,1.5,2602,0.1,49393,1.1
2011,Louisiana,4574836,2236117,48.9,2338719,51.1,3455588,3455588,1663775,48.1,1791813,51.9,77661,1.7,4497175,98.3,2941935,64.3,1510994,33,58144,1.3,86891,1.9,4570,0.1,58164,1.3
2011,Maine,1328188,651076,49,677112,51,1057866,1057866,511029,48.3,546837,51.7,25067,1.9,1303121,98.1,1288000,97,20057,1.5,22863,1.7,18265,1.4,574,0,4426,0.3
2011,Maryland,5828289,2820212,48.4,3008077,51.6,4481657,4481657,2134178,47.6,2347479,52.4,151945,2.6,5676344,97.4,3536068,60.7,1808779,31,49384,0.8,378646,6.5,7338,0.1,212554,3.6
2011,Massachusetts,6587536,3187794,48.4,3399742,51.6,5182429,5182429,2469937,47.7,2712492,52.3,168058,2.6,6419478,97.4,5450859,82.7,540769,8.2,42744,0.6,408604,6.2,5789,0.1,318477,4.8
2011,Michigan,9876187,4848677,49.1,5027510,50.9,7583102,7583102,3673776,48.4,3909326,51.6,252831,2.6,9623356,97.4,8052259,81.5,1510609,15.3,143760,1.5,297203,3,8349,0.1,133760,1.4
2011,Minnesota,5344861,2656471,49.7,2688390,50.3,4067200,4067200,2001738,49.2,2065462,50.8,134971,2.5,5209890,97.5,4699947,87.9,340401,6.4,106988,2,252051,4.7,4079,0.1,87361,1.6
2011,Mississippi,2978512,1446634,48.6,1531878,51.4,2226571,2226571,1061768,47.7,1164803,52.3,34342,1.2,2944170,98.8,1800210,60.4,1135835,38.1,22579,0.8,32073,1.1,1031,0,24412,0.8
2011,Missouri,6010688,2945756,49,3064932,51,4596993,4596993,2221379,48.3,2375614,51.7,145134,2.4,5865554,97.6,5121421,85.2,754641,12.6,76617,1.3,125353,2.1,11157,0.2,74862,1.2
2011,Montana,998199,500311,50.1,497888,49.9,775128,775128,385683,49.8,389445,50.2,24125,2.4,974074,97.6,914605,91.6,7100,0.7,84557,8.5,10043,1,1855,0.2,6218,0.6
2011,Nebraska,1842641,912496,49.5,930145,50.5,1382015,1382015,676985,49,705030,51,40375,2.2,1802266,97.8,1659694,90.1,101529,5.5,31591,1.7,43032,2.3,2418,0.1,47475,2.6
2011,Nevada,2723322,1372750,50.4,1350572,49.6,2060219,2060219,1034399,50.2,1025820,49.8,105845,3.9,2617477,96.1,2030661,74.6,253565,9.3,54152,2,247866,9.1,34135,1.3,216342,7.9
2011,New Hampshire,1318194,651060,49.4,667134,50.6,1038525,1038525,507574,48.9,530951,51.1,22642,1.7,1295552,98.3,1262843,95.8,20099,1.5,9344,0.7,38043,2.9,1028,0.1,10739,0.8
2011,New Jersey,8821155,4298542,48.7,4522613,51.3,6778730,6778730,3254119,48,3524611,52,216816,2.5,8604339,97.5,6274271,71.1,1286782,14.6,63448,0.7,812989,9.2,12560,0.1,606522,6.9
2011,New Mexico,2082224,1036558,49.8,1045666,50.2,1564471,1564471,767783,49.1,796688,50.9,64215,3.1,2018009,96.9,1547066,74.3,60449,2.9,215752,10.4,38133,1.8,3299,0.2,286642,13.8
2011,New York,19465197,9438007,48.5,10027190,51.5,15185575,15185575,7245549,47.7,7940026,52.3,526783,2.7,18938414,97.3,13105287,67.3,3290177,16.9,168521,0.9,1595953,8.2,22789,0.1,1843190,9.5
2011,North Carolina,9656401,4687843,48.5,4968558,51.5,7367259,7367259,3529894,47.9,3837365,52.1,204855,2.1,9451546,97.9,6940561,71.9,2203745,22.8,177747,1.8,254183,2.6,12183,0.1,295007,3.1
2011,North Dakota,683932,343944,50.3,339988,49.7,532654,532654,268091,50.3,264563,49.7,12654,1.9,671278,98.1,626421,91.6,10553,1.5,44379,6.5,10125,1.5,937,0.1,4944,0.7
2011,Ohio,11544951,5641528,48.9,5903423,51.1,8852579,8852579,4263437,48.2,4589142,51.8,266099,2.3,11278852,97.7,9807803,85,1561767,13.5,89190,0.8,244572,2.1,10780,0.1,120781,1
2011,Oklahoma,3791508,1877843,49.5,1913665,50.5,2855875,2855875,1398064,49,1457811,51,301647,8,3489861,92,3069926,81,335093,8.8,502934,13.3,84912,2.2,8582,0.2,107116,2.8
2011,Oregon,3871859,1914116,49.4,1957743,50.6,3009839,3009839,1472370,48.9,1537469,51.1,134681,3.5,3737178,96.5,3399910,87.8,99758,2.6,109489,2.8,194863,5,29645,0.8,185589,4.8
2011,Pennsylvania,12742886,6216838,48.8,6526048,51.2,9981972,9981972,4800985,48.1,5180987,51.9,247261,1.9,12495625,98.1,10700243,84,1515042,11.9,72799,0.6,414861,3.3,10350,0.1,297000,2.3
2011,Puerto Rico,3706690,1770224,47.8,1936466,52.2,2830195,2830195,1325325,46.8,1504870,53.2,497663,13.4,3209027,86.6,3029292,81.7,766760,20.7,22907,0.6,13187,0.4,688,0,385400,10.4
2011,Rhode Island,1051302,508396,48.4,542906,51.6,832228,832228,396339,47.6,435889,52.4,28756,2.7,1022546,97.3,880041,83.7,79720,7.6,12823,1.2,38814,3.7,955,0.1,70392,6.7
2011,South Carolina,4679230,2274282,48.6,2404948,51.4,3597217,3597217,1723794,47.9,1873423,52.1,84391,1.8,4594839,98.2,3207551,68.5,1350958,28.9,41839,0.9,77233,1.7,6077,0.1,84956,1.8
2011,South Dakota,824082,410505,49.8,413577,50.2,622233,622233,308543,49.6,313690,50.4,20140,2.4,803942,97.6,727015,88.2,14917,1.8,85955,10.4,9126,1.1,279,0,8153,1
2011,Tennessee,6403353,3118951,48.7,3284402,51.3,4912899,4912899,2358728,48,2554171,52,121474,1.9,6281879,98.1,5100851,79.7,1125026,17.6,66125,1,114333,1.8,5932,0.1,120710,1.9
2011,Texas,25674681,12741162,49.6,12933519,50.4,18716999,18716999,9182680,49.1,9534319,50.9,596902,2.3,25077779,97.7,19649143,76.5,3223055,12.6,295669,1.2,1155009,4.5,47206,0.2,1935347,7.5
2011,Utah,2817222,1417639,50.3,1399583,49.7,1936143,1936143,964327,49.8,971816,50.2,69358,2.5,2747864,97.5,2546578,90.4,47618,1.7,51025,1.8,80591,2.9,39628,1.4,126630,4.5
2011,Vermont,626431,308393,49.2,318038,50.8,500510,500510,244021,48.8,256489,51.2,13639,2.2,612792,97.8,609323,97.3,9257,1.5,8295,1.3,11548,1.8,322,0.1,2012,0.3
2011,Virginia,8096604,3978779,49.1,4117825,50.9,6243511,6243511,3026460,48.5,3217051,51.5,240746,3,7855858,97,5819499,71.9,1698860,21,80009,1,542341,6.7,15241,0.2,206828,2.6
2011,Washington,6830038,3408061,49.9,3421977,50.1,5249796,5249796,2598833,49.5,2650963,50.5,320819,4.7,6509219,95.3,5638753,82.6,335290,4.9,195098,2.9,624622,9.1,77078,1.1,314301,4.6
2011,West Virginia,1855364,914474,49.3,940890,50.7,1468533,1468533,715129,48.7,753404,51.3,38367,2.1,1816997,97.9,1777699,95.8,74153,4,21452,1.2,15700,0.8,760,0,5954,0.3
2011,Wisconsin,5711767,2835132,49.6,2876635,50.4,4387367,4387367,2157197,49.2,2230170,50.8,116797,2,5594970,98,5083936,89,408046,7.1,90634,1.6,154925,2.7,6190,0.1,93160,1.6
2011,Wyoming,568158,289416,50.9,278742,49.1,433067,433067,220087,50.8,212980,49.2,15640,2.8,552518,97.2,530643,93.4,7940,1.4,21388,3.8,6929,1.2,831,0.1,16886,3
2012,Alabama,4822023,2336291,48.5,2485732,51.5,3697048,3697048,1761220,47.6,1935828,52.4,75847,1.6,4746176,98.4,3398071,70.5,1310976,27.2,57374,1.2,71714,1.5,4258,0.1,59235,1.2
2012,Alaska,731449,381094,52.1,350355,47.9,544184,544184,284144,52.2,260040,47.8,58292,8,673157,92,538535,73.6,37564,5.1,143610,19.6,55476,7.6,11389,1.6,9624,1.3
2012,Arizona,6553255,3260687,49.8,3292568,50.2,4933670,4933670,2431746,49.3,2501924,50.7,189501,2.9,6363754,97.1,5323886,81.2,340788,5.2,350960,5.4,244376,3.7,30804,0.5,464975,7.1
2012,Arkansas,2949131,1449265,49.1,1499866,50.9,2237502,2237502,1081741,48.3,1155761,51.7,57979,2,2891152,98,2362575,80.1,480360,16.3,49660,1.7,47505,1.6,7304,0.2,63753,2.2
2012,California,38041430,18917773,49.7,19123657,50.3,28802124,28802124,14192689,49.3,14609435,50.7,1683860,4.4,36357570,95.6,25004041,65.7,2698776,7.1,710007,1.9,5827368,15.3,301700,0.8,5346248,14.1
2012,Colorado,5187582,2601370,50.1,2586212,49.9,3956275,3956275,1972797,49.9,1983478,50.1,172713,3.3,5014869,96.7,4527141,87.3,264690,5.1,103105,2,200532,3.9,13755,0.3,262683,5.1
2012,Connecticut,3590347,1749806,48.7,1840541,51.3,2797581,2797581,1344132,48,1453449,52,93884,2.6,3496463,97.4,2881623,80.3,417627,11.6,30459,0.8,169775,4.7,4969,0.1,186897,5.2
2012,Delaware,917092,444691,48.5,472401,51.5,712172,712172,340061,47.7,372111,52.3,23953,2.6,893139,97.4,660236,72,211941,23.1,7426,0.8,35927,3.9,823,0.1,26817,2.9
2012,Florida,19317568,9441001,48.9,9876567,51.1,15316595,15316595,7401395,48.3,7915200,51.7,458760,2.4,18858808,97.6,15120922,78.3,3333615,17.3,145804,0.8,617029,3.2,38004,0.2,555866,2.9
2012,Georgia,9919945,4851053,48.9,5068892,51.1,7424198,7424198,3574932,48.2,3849266,51.8,201856,2,9718089,98,6158664,62.1,3175239,32,73204,0.7,394171,4,12193,0.1,326526,3.3
2012,Hawaii,1392313,701196,50.4,691117,49.6,1089432,1089432,545866,50.1,543566,49.9,323725,23.3,1068588,76.7,588604,42.3,44653,3.2,29080,2.1,785044,56.4,363137,26.1,36398,2.6
2012,Idaho,1595728,798712,50.1,797016,49.9,1170976,1170976,581273,49.6,589703,50.4,39524,2.5,1556204,97.5,1496131,93.8,15302,1,38403,2.4,34275,2.1,4464,0.3,49831,3.1
2012,Illinois,12875255,6316653,49.1,6558602,50.9,9812204,9812204,4752883,48.4,5059321,51.6,282835,2.2,12592420,97.8,9597951,74.5,1984983,15.4,86421,0.7,699155,5.4,13348,0.1,791920,6.2
2012,Indiana,6537334,3217145,49.2,3320189,50.8,4947915,4947915,2402447,48.6,2545468,51.4,141815,2.2,6395519,97.8,5640105,86.3,671172,10.3,55248,0.8,136287,2.1,5107,0.1,177190,2.7
2012,Iowa,3074186,1524107,49.6,1550079,50.4,2351520,2351520,1153459,49.1,1198061,50.9,59977,2,3014209,98,2875961,93.6,119717,3.9,27355,0.9,67528,2.2,3311,0.1,44080,1.4
2012,Kansas,2885905,1434617,49.7,1451288,50.3,2164628,2164628,1067435,49.3,1097193,50.7,91493,3.2,2794412,96.8,2549961,88.4,209891,7.3,61444,2.1,89447,3.1,5456,0.2,68754,2.4
2012,Kentucky,4380415,2154939,49.2,2225476,50.8,3362436,3362436,1632674,48.6,1729762,51.4,87211,2,4293204,98,3925032,89.6,393202,9,34011,0.8,69351,1.6,4276,0.1,47697,1.1
2012,Louisiana,4601893,2248888,48.9,2353005,51.1,3482769,3482769,1679036,48.2,1803733,51.8,78475,1.7,4523418,98.3,2957695,64.3,1523992,33.1,57677,1.3,87555,1.9,6036,0.1,56964,1.2
2012,Maine,1329192,650714,49,678478,51,1063205,1063205,513567,48.3,549638,51.7,26105,2,1303087,98,1289000,97,21612,1.6,22354,1.7,19462,1.5,578,0,3814,0.3
2012,Maryland,5884563,2849291,48.4,3035272,51.6,4541628,4541628,2165290,47.7,2376338,52.3,183623,3.1,5700940,96.9,3565747,60.6,1821060,30.9,62415,1.1,397531,6.8,10537,0.2,227680,3.9
2012,Massachusetts,6646144,3219753,48.4,3426391,51.6,5244889,5244889,2504198,47.7,2740691,52.3,183787,2.8,6462357,97.2,5482773,82.5,574269,8.6,46796,0.7,425516,6.4,5770,0.1,307931,4.6
2012,Michigan,9883360,4851429,49.1,5031931,50.9,7615737,7615737,3689583,48.4,3926154,51.6,254344,2.6,9629016,97.4,8064202,81.6,1512368,15.3,140910,1.4,306423,3.1,8783,0.1,121991,1.2
2012,Minnesota,5379139,2670741,49.6,2708398,50.4,4101339,4101339,2017849,49.2,2083490,50.8,136449,2.5,5242690,97.5,4721186,87.8,346566,6.4,101612,1.9,262496,4.9,8073,0.2,85519,1.6
2012,Mississippi,2984926,1442072,48.3,1542854,51.7,2237257,2237257,1062706,47.5,1174551,52.5,32852,1.1,2952074,98.9,1798463,60.3,1141689,38.2,23273,0.8,31294,1,1190,0,24593,0.8
2012,Missouri,6021988,2953591,49,3068397,51,4618282,4618282,2231016,48.3,2387266,51.7,142826,2.4,5879162,97.6,5107852,84.8,756167,12.6,84547,1.4,129258,2.1,8780,0.1,85869,1.4
2012,Montana,1005141,503458,50.1,501683,49.9,785001,785001,390656,49.8,394345,50.2,25770,2.6,979371,97.4,921097,91.6,8444,0.8,81218,8.1,11394,1.1,2501,0.2,8047,0.8
2012,Nebraska,1855525,923099,49.7,932426,50.3,1392723,1392723,684793,49.2,707930,50.8,38621,2.1,1816904,97.9,1671127,90.1,102907,5.5,29141,1.6,45562,2.5,3366,0.2,46907,2.5
2012,Nevada,2758931,1391864,50.4,1367067,49.6,2094509,2094509,1049903,50.1,1044606,49.9,114448,4.1,2644483,95.9,2014131,73,267298,9.7,54843,2,257625,9.3,33164,1.2,258059,9.4
2012,New Hampshire,1320718,648288,49.1,672430,50.9,1045696,1045696,509196,48.7,536500,51.3,24216,1.8,1296502,98.2,1264533,95.7,24691,1.9,12042,0.9,36463,2.8,1477,0.1,8654,0.7
2012,New Jersey,8864590,4321436,48.7,4543154,51.3,6837852,6837852,3287144,48.1,3550708,51.9,222804,2.5,8641786,97.5,6283790,70.9,1317691,14.9,63266,0.7,844163,9.5,11045,0.1,586151,6.6
2012,New Mexico,2085538,1034877,49.6,1050661,50.4,1569690,1569690,770107,49.1,799583,50.9,65699,3.2,2019839,96.8,1554528,74.5,58675,2.8,216225,10.4,40075,1.9,3555,0.2,281436,13.5
2012,New York,19570261,9485872,48.5,10084389,51.5,15309251,15309251,7308076,47.7,8001175,52.3,533012,2.7,19037249,97.3,13165776,67.3,3301075,16.9,187058,1,1654819,8.5,26086,0.1,1814293,9.3
2012,North Carolina,9752073,4751047,48.7,5001026,51.3,7468071,7468071,3584761,48,3883310,52,224210,2.3,9527863,97.7,7003714,71.8,2233164,22.9,186442,1.9,271751,2.8,12036,0.1,288699,3
2012,North Dakota,699628,357591,51.1,342037,48.9,545530,545530,277908,50.9,267622,49.1,14090,2,685538,98,639536,91.4,13977,2,44470,6.4,8900,1.3,1649,0.2,5406,0.8
2012,Ohio,11544225,5642634,48.9,5901591,51.1,8884300,8884300,4281485,48.2,4602815,51.8,265974,2.3,11278251,97.7,9786393,84.8,1571492,13.6,95344,0.8,250368,2.2,11908,0.1,117124,1
2012,Oklahoma,3814820,1889807,49.5,1925013,50.5,2878536,2878536,1410099,49,1468437,51,294500,7.7,3520320,92.3,3071749,80.5,339190,8.9,511353,13.4,88846,2.3,7934,0.2,103624,2.7
2012,Oregon,3899353,1932789,49.6,1966564,50.4,3038607,3038607,1488594,49,1550013,51,156351,4,3743002,96,3466202,88.9,100569,2.6,117529,3,199752,5.1,29812,0.8,156815,4
2012,Pennsylvania,12763536,6229333,48.8,6534203,51.2,10026082,10026082,4828422,48.2,5197660,51.8,263597,2.1,12499939,97.9,10679676,83.7,1551490,12.2,81764,0.6,427212,3.3,21838,0.2,286317,2.2
2012,Puerto Rico,3667084,1757273,47.9,1909811,52.1,2817723,2817723,1319819,46.8,1497904,53.2,447304,12.2,3219780,87.8,2974673,81.1,734636,20,24043,0.7,16646,0.5,347,0,372793,10.2
2012,Rhode Island,1050292,506835,48.3,543457,51.7,833330,833330,395951,47.5,437379,52.5,29207,2.8,1021085,97.2,880518,83.8,84888,8.1,13461,1.3,39044,3.7,1637,0.2,63236,6
2012,South Carolina,4723723,2295781,48.6,2427942,51.4,3642747,3642747,1743817,47.9,1898930,52.1,94735,2,4628988,98,3246053,68.7,1361147,28.8,40179,0.9,80115,1.7,6253,0.1,90915,1.9
2012,South Dakota,833354,417803,50.1,415551,49.9,629132,629132,313492,49.8,315640,50.2,17680,2.1,815674,97.9,728083,87.4,18182,2.2,83595,10,11253,1.4,1136,0.1,9424,1.1
2012,Tennessee,6456243,3144756,48.7,3311487,51.3,4962026,4962026,2382162,48,2579864,52,118364,1.8,6337879,98.2,5144114,79.7,1144635,17.7,58099,0.9,121128,1.9,7178,0.1,106099,1.6
2012,Texas,26059203,12945218,49.7,13113985,50.3,19078028,19078028,9377716,49.2,9700312,50.8,614423,2.4,25444780,97.6,20073596,77,3312610,12.7,315126,1.2,1208013,4.6,48910,0.2,1753852,6.7
2012,Utah,2855287,1435028,50.3,1420259,49.7,1968099,1968099,979928,49.8,988171,50.2,69599,2.4,2785688,97.6,2580238,90.4,46478,1.6,49030,1.7,86157,3,38966,1.4,131082,4.6
2012,Vermont,626011,309184,49.4,316827,50.6,502122,502122,245029,48.8,257093,51.2,12600,2,613411,98,607276,97,10164,1.6,8411,1.3,11119,1.8,265,0,2335,0.4
2012,Virginia,8185867,4015045,49,4170822,51,6331235,6331235,3070192,48.5,3261043,51.5,263693,3.2,7922174,96.8,5880677,71.8,1701315,20.8,87891,1.1,565539,6.9,16112,0.2,223540,2.7
2012,Washington,6897012,3441429,49.9,3455583,50.1,5311983,5311983,2627922,49.5,2684061,50.5,344462,5,6552550,95,5701323,82.7,343329,5,204438,3,651794,9.5,81694,1.2,294855,4.3
2012,West Virginia,1855413,911681,49.1,943732,50.9,1471193,1471193,716511,48.7,754682,51.3,36029,1.9,1819384,98.1,1770763,95.4,75597,4.1,24492,1.3,15626,0.8,1366,0.1,6059,0.3
2012,Wisconsin,5726398,2842737,49.6,2883661,50.4,4409648,4409648,2167357,49.2,2242291,50.8,114330,2,5612068,98,5071173,88.6,410255,7.2,90149,1.6,158904,2.8,4298,0.1,112696,2
2012,Wyoming,576412,292736,50.8,283676,49.2,439802,439802,222362,50.6,217440,49.4,17643,3.1,558769,96.9,540418,93.8,11245,2,22431,3.9,7201,1.2,994,0.2,12968,2.2
2013,Alabama,4833722,2341869,48.4,2491853,51.6,3723831,3723831,1777097,47.7,1946734,52.3,81754,1.7,4751968,98.3,3401903,70.4,1322048,27.4,53515,1.1,73661,1.5,3866,0.1,64417,1.3
2013,Alaska,735132,386404,52.6,348728,47.4,546766,546766,288959,52.8,257807,47.2,56906,7.7,678226,92.3,537444,73.1,37535,5.1,142190,19.3,55379,7.5,11459,1.6,11724,1.6
2013,Arizona,6626624,3298086,49.8,3328538,50.2,5010662,5010662,2472154,49.3,2538508,50.7,211808,3.2,6414816,96.8,5413397,81.7,342388,5.2,355878,5.4,260177,3.9,24656,0.4,456726,6.9
2013,Arkansas,2959373,1461544,49.4,1497829,50.6,2247751,2247751,1090535,48.5,1157216,51.5,65224,2.2,2894149,97.8,2364252,79.9,491932,16.6,46969,1.6,48568,1.6,2866,0.1,72833,2.5
2013,California,38332521,19072246,49.8,19260275,50.2,29158337,29158337,14374509,49.3,14783828,50.7,1729710,4.5,36602811,95.5,25158328,65.6,2710456,7.1,709952,1.9,5959446,15.5,289593,0.8,5407677,14.1
2013,Colorado,5268367,2645976,50.2,2622391,49.8,4027042,4027042,2011182,49.9,2015860,50.1,189032,3.6,5079335,96.4,4584926,87,269750,5.1,108821,2.1,206578,3.9,17303,0.3,290373,5.5
2013,Connecticut,3596080,1751883,48.7,1844197,51.3,2810738,2810738,1352395,48.1,1458343,51.9,104927,2.9,3491153,97.1,2864286,79.7,423002,11.8,31828,0.9,172702,4.8,4137,0.1,214528,6
2013,Delaware,925749,447789,48.4,477960,51.6,722061,722061,344418,47.7,377643,52.3,26430,2.9,899319,97.1,660772,71.4,218379,23.6,10703,1.2,38699,4.2,1058,0.1,25927,2.8
2013,Florida,19552860,9565609,48.9,9987251,51.1,15524130,15524130,7499351,48.3,8024779,51.7,459313,2.3,19093547,97.7,15279072,78.1,3375997,17.3,147203,0.8,638941,3.3,28987,0.1,577729,3
2013,Georgia,9992167,4879034,48.8,5113133,51.2,7501786,7501786,3607292,48.1,3894494,51.9,210843,2.1,9781324,97.9,6208527,62.1,3216618,32.2,71533,0.7,410259,4.1,12314,0.1,302598,3
2013,Hawaii,1404054,710917,50.6,693137,49.4,1096828,1096828,552184,50.3,544644,49.7,330017,23.5,1074037,76.5,597324,42.5,50802,3.6,32783,2.3,783648,55.8,361467,25.7,38812,2.8
2013,Idaho,1612136,810879,50.3,801257,49.7,1185282,1185282,588418,49.6,596864,50.4,38746,2.4,1573390,97.6,1510664,93.7,16909,1,38992,2.4,34241,2.1,3979,0.2,48564,3
2013,Illinois,12882135,6326778,49.1,6555357,50.9,9859980,9859980,4781706,48.5,5078274,51.5,289362,2.2,12592773,97.8,9607581,74.6,1966540,15.3,90532,0.7,721358,5.6,14844,0.1,791021,6.1
2013,Indiana,6570902,3228884,49.1,3342018,50.9,4983360,4983360,2417934,48.5,2565426,51.5,142851,2.2,6428051,97.8,5660014,86.1,675350,10.3,54687,0.8,145535,2.2,6958,0.1,180376,2.7
2013,Iowa,3090416,1528770,49.5,1561646,50.5,2366950,2366950,1158473,48.9,1208477,51.1,52836,1.7,3037580,98.3,2872646,93,127527,4.1,22784,0.7,74354,2.4,3227,0.1,45930,1.5
2013,Kansas,2893957,1440481,49.8,1453476,50.2,2173415,2173415,1070902,49.3,1102513,50.7,95568,3.3,2798389,96.7,2565215,88.6,206702,7.1,63602,2.2,91992,3.2,3679,0.1,65846,2.3
2013,Kentucky,4395295,2163067,49.2,2232228,50.8,3380710,3380710,1642437,48.6,1738273,51.4,87729,2,4307566,98,3933038,89.5,401053,9.1,28417,0.6,69887,1.6,5409,0.1,50313,1.1
2013,Louisiana,4625470,2256464,48.8,2369006,51.2,3512796,3512796,1694822,48.2,1817974,51.8,77921,1.7,4547549,98.3,2974256,64.3,1535429,33.2,56586,1.2,87512,1.9,2826,0.1,53722,1.2
2013,Maine,1328302,649994,48.9,678308,51.1,1067967,1067967,516564,48.4,551403,51.6,27834,2.1,1300468,97.9,1287835,97,20508,1.5,23952,1.8,19760,1.5,737,0.1,4627,0.3
2013,Maryland,5928814,2875157,48.5,3053657,51.5,4584357,4584357,2189618,47.8,2394739,52.2,169460,2.9,5759354,97.1,3553697,59.9,1846094,31.1,58364,1,416244,7,10016,0.2,234732,4
2013,Massachusetts,6692824,3245774,48.5,3447050,51.5,5299869,5299869,2531628,47.8,2768241,52.2,198615,3,6494209,97,5503528,82.2,581224,8.7,45461,0.7,444537,6.6,8775,0.1,321284,4.8
2013,Michigan,9895622,4858138,49.1,5037484,50.9,7651883,7651883,3708170,48.5,3943713,51.5,265849,2.7,9629773,97.3,8063753,81.5,1510277,15.3,152669,1.5,320901,3.2,9385,0.1,125189,1.3
2013,Minnesota,5420380,2690694,49.6,2729686,50.4,4137786,4137786,2035662,49.2,2102124,50.8,146761,2.7,5273619,97.3,4729035,87.2,359827,6.6,106567,2,273717,5,6994,0.1,100890,1.9
2013,Mississippi,2991207,1451232,48.5,1539975,51.5,2254067,2254067,1074627,47.7,1179440,52.3,32269,1.1,2958938,98.9,1791226,59.9,1148139,38.4,22855,0.8,35297,1.2,1729,0.1,27440,0.9
2013,Missouri,6044171,2960402,49,3083769,51,4645096,4645096,2245217,48.3,2399879,51.7,151987,2.5,5892184,97.5,5138632,85,763283,12.6,80074,1.3,134195,2.2,12454,0.2,77715,1.3
2013,Montana,1015165,507018,49.9,508147,50.1,791069,791069,393667,49.8,397402,50.2,25896,2.6,989269,97.4,929045,91.5,6904,0.7,84982,8.4,12151,1.2,3338,0.3,7154,0.7
2013,Nebraska,1868516,925274,49.5,943242,50.5,1404764,1404764,690886,49.2,713878,50.8,42862,2.3,1825654,97.7,1689446,90.4,103130,5.5,28369,1.5,46451,2.5,3637,0.2,42809,2.3
2013,Nevada,2790136,1403068,50.3,1387068,49.7,2128489,2128489,1066101,50.1,1062388,49.9,117408,4.2,2672728,95.8,2001067,71.7,272650,9.8,54191,1.9,266463,9.6,37989,1.4,288328,10.3
2013,New Hampshire,1323459,652662,49.3,670797,50.7,1052284,1052284,515421,49,536863,51,25389,1.9,1298070,98.1,1260892,95.3,26176,2,12330,0.9,37487,2.8,1084,0.1,12504,0.9
2013,New Jersey,8899339,4343749,48.8,4555590,51.2,6877442,6877442,3309625,48.1,3567817,51.9,217338,2.4,8682001,97.6,6245124,70.2,1329794,14.9,57891,0.7,866717,9.7,9381,0.1,629843,7.1
2013,New Mexico,2085287,1034144,49.6,1051143,50.4,1577203,1577203,775681,49.2,801522,50.8,69402,3.3,2015885,96.7,1627403,78,58206,2.8,217737,10.4,43118,2.1,4864,0.2,207375,9.9
2013,New York,19651127,9536179,48.5,10114948,51.5,15411865,15411865,7365855,47.8,8046010,52.2,564694,2.9,19086433,97.1,13140134,66.9,3354246,17.1,194476,1,1708354,8.7,31482,0.2,1849393,9.4
2013,North Carolina,9848060,4795976,48.7,5052084,51.3,7563892,7563892,3628753,48,3935139,52,236144,2.4,9611916,97.6,7004568,71.1,2250063,22.8,192149,2,290016,2.9,16551,0.2,355619,3.6
2013,North Dakota,723393,369155,51,354238,49,562700,562700,286955,51,275745,49,14787,2,708606,98,657943,91,15677,2.2,47893,6.6,11312,1.6,1078,0.1,5655,0.8
2013,Ohio,11570808,5658223,48.9,5912585,51.1,8922022,8922022,4303344,48.2,4618678,51.8,295959,2.6,11274849,97.4,9810763,84.8,1590052,13.7,93248,0.8,265734,2.3,11398,0.1,119587,1
2013,Oklahoma,3850568,1906922,49.5,1943646,50.5,2902736,2902736,1420299,48.9,1482437,51.1,287445,7.5,3563123,92.5,3075284,79.9,343169,8.9,513097,13.3,92006,2.4,9851,0.3,120368,3.1
2013,Oregon,3930065,1946196,49.5,1983869,50.5,3070537,3070537,1503938,49,1566599,51,165780,4.2,3764285,95.8,3521410,89.6,106605,2.7,115952,3,210876,5.4,28965,0.7,130900,3.3
2013,Pennsylvania,12773801,6243308,48.9,6530493,51.1,10057548,10057548,4853526,48.3,5204022,51.7,263108,2.1,12510693,97.9,10654728,83.4,1561655,12.2,88278,0.7,439900,3.4,14166,0.1,300487,2.4
2013,Puerto Rico,3615086,1729120,47.8,1885966,52.2,2801012,2801012,1309983,46.8,1491029,53.2,323843,9,3291243,91,2910145,80.5,583619,16.1,29255,0.8,13390,0.4,440,0,411871,11.4
2013,Rhode Island,1051511,512999,48.8,538512,51.2,838664,838664,402131,47.9,436533,52.1,26902,2.6,1024609,97.4,867478,82.5,81703,7.8,9930,0.9,40345,3.8,2406,0.2,78093,7.4
2013,South Carolina,4774839,2321179,48.6,2453660,51.4,3695519,3695519,1772284,48,1923235,52,90748,1.9,4684091,98.1,3286933,68.8,1369363,28.7,40496,0.8,84373,1.8,5646,0.1,84187,1.8
2013,South Dakota,844877,424160,50.2,420717,49.8,636396,636396,317110,49.8,319286,50.2,24537,2.9,820340,97.1,741992,87.8,18214,2.2,88615,10.5,12149,1.4,1184,0.1,8332,1
2013,Tennessee,6495978,3174148,48.9,3321830,51.1,5003897,5003897,2407490,48.1,2596407,51.9,123223,1.9,6372755,98.1,5174672,79.7,1163293,17.9,55831,0.9,121337,1.9,6743,0.1,104933,1.6
2013,Texas,26448193,13145494,49.7,13302699,50.3,19407275,19407275,9541917,49.2,9865358,50.8,646884,2.4,25801309,97.6,20390376,77.1,3387339,12.8,317675,1.2,1257835,4.8,46497,0.2,1744503,6.6
2013,Utah,2900872,1458758,50.3,1442114,49.7,2004041,2004041,997107,49.8,1006934,50.2,70470,2.4,2830402,97.6,2598469,89.6,46483,1.6,47112,1.6,90338,3.1,39208,1.4,155656,5.4
2013,Vermont,626630,308672,49.3,317958,50.7,502500,502500,244834,48.7,257666,51.3,13224,2.1,613406,97.9,607707,97,11308,1.8,7303,1.2,11449,1.8,485,0.1,2260,0.4
2013,Virginia,8260405,4060533,49.2,4199872,50.8,6396074,6396074,3110547,48.6,3285527,51.4,268511,3.3,7991894,96.7,5958033,72.1,1723083,20.9,77340,0.9,586801,7.1,17495,0.2,189701,2.3
2013,Washington,6971406,3475830,49.9,3495576,50.1,5375222,5375222,2664111,49.6,2711111,50.4,343159,4.9,6628247,95.1,5744515,82.4,358255,5.1,210161,3,678167,9.7,75252,1.1,287080,4.1
2013,West Virginia,1854304,916834,49.4,937470,50.6,1472047,1472047,719823,48.9,752224,51.1,33919,1.8,1820385,98.2,1769292,95.4,79082,4.3,17742,1,14523,0.8,2199,0.1,6864,0.4
2013,Wisconsin,5742713,2855502,49.7,2887211,50.3,4436791,4436791,2185301,49.3,2251490,50.7,121173,2.1,5621540,97.9,5083260,88.5,414759,7.2,91937,1.6,168376,2.9,5195,0.1,111603,1.9
2013,Wyoming,582658,297497,51.1,285161,48.9,442883,442883,224506,50.7,218377,49.3,15982,2.7,566676,97.3,542672,93.1,10758,1.8,23090,4,8220,1.4,623,0.1,14105,2.4
2014,Alabama,4849377,2347969,48.4,2501408,51.6,3740777,3740777,1781840,47.6,1958937,52.4,84964,1.8,4764413,98.2,3393131,70,1333571,27.5,56612,1.2,74904,1.5,5223,0.1,76324,1.6
2014,Alaska,736732,385582,52.3,351150,47.7,549963,549963,290721,52.9,259242,47.1,62808,8.5,673924,91.5,539335,73.2,38875,5.3,143009,19.4,56354,7.6,13621,1.8,13859,1.9
2014,Arizona,6731484,3342946,49.7,3388538,50.3,5109413,5109413,2515348,49.2,2594065,50.8,224103,3.3,6507381,96.7,5463616,81.2,356336,5.3,370817,5.5,270014,4,28690,0.4,487321,7.2
2014,Arkansas,2966369,1456778,49.1,1509591,50.9,2260229,2260229,1095536,48.5,1164693,51.5,64487,2.2,2901882,97.8,2382371,80.3,490493,16.5,47883,1.6,47459,1.6,9699,0.3,55992,1.9
2014,California,38802500,19264457,49.6,19538043,50.4,29650921,29650921,14593490,49.2,15057431,50.8,1779789,4.6,37022711,95.4,25303253,65.2,2731697,7,738842,1.9,6145595,15.8,302712,0.8,5534138,14.3
2014,Colorado,5355866,2692599,50.3,2663267,49.7,4108721,4108721,2050929,49.9,2057792,50.1,184328,3.4,5171538,96.6,4682276,87.4,272729,5.1,119786,2.2,210426,3.9,17666,0.3,254201,4.7
2014,Connecticut,3596677,1754116,48.8,1842561,51.2,2821801,2821801,1358421,48.1,1463380,51.9,103833,2.9,3492844,97.1,2849268,79.2,420760,11.7,31803,0.9,181568,5,3159,0.1,223064,6.2
2014,Delaware,935614,454005,48.5,481609,51.5,731772,731772,349689,47.8,382083,52.2,24117,2.6,911497,97.4,668734,71.5,220001,23.5,7955,0.9,40345,4.3,2015,0.2,22933,2.5
2014,Florida,19893297,9722228,48.9,10171069,51.1,15839274,15839274,7650549,48.3,8188725,51.7,475805,2.4,19417492,97.6,15516318,78,3451722,17.4,155662,0.8,663476,3.3,42692,0.2,583435,2.9
2014,Georgia,10097343,4921939,48.7,5175404,51.3,7605922,7605922,3650246,48,3955676,52,203303,2,9894040,98,6210810,61.5,3273686,32.4,74127,0.7,427292,4.2,14802,0.1,313755,3.1
2014,Hawaii,1419561,717313,50.5,702248,49.5,1111207,1111207,559170,50.3,552037,49.7,330299,23.3,1089262,76.7,605053,42.6,51166,3.6,30044,2.1,792522,55.8,362880,25.6,31670,2.2
2014,Idaho,1634464,817050,50,817414,50,1203199,1203199,595426,49.5,607773,50.5,40796,2.5,1593668,97.5,1536612,94,18808,1.2,39683,2.4,35200,2.2,3560,0.2,43494,2.7
2014,Illinois,12880580,6320605,49.1,6559975,50.9,9895846,9895846,4798893,48.5,5096953,51.5,291567,2.3,12589013,97.7,9539802,74.1,1964507,15.3,95799,0.7,746311,5.8,14225,0.1,830288,6.4
2014,Indiana,6596855,3243979,49.2,3352876,50.8,5013181,5013181,2433745,48.5,2579436,51.5,146115,2.2,6450740,97.8,5680448,86.1,694341,10.5,47921,0.7,156929,2.4,8646,0.1,163928,2.5
2014,Iowa,3107126,1544801,49.7,1562325,50.3,2381535,2381535,1170603,49.2,1210932,50.8,60385,1.9,3046741,98.1,2893170,93.1,130300,4.2,23478,0.8,83705,2.7,4694,0.2,36211,1.2
2014,Kansas,2904021,1444945,49.8,1459076,50.2,2181534,2181534,1075613,49.3,1105921,50.7,99562,3.4,2804459,96.6,2556920,88,214723,7.4,65002,2.2,93847,3.2,6098,0.2,75032,2.6
2014,Kentucky,4413457,2174158,49.3,2239299,50.7,3398154,3398154,1651276,48.6,1746878,51.4,94243,2.1,4319214,97.9,3945501,89.4,408677,9.3,31837,0.7,69351,1.6,5242,0.1,50505,1.1
2014,Louisiana,4649676,2272116,48.9,2377560,51.1,3534892,3534892,1703912,48.2,1830980,51.8,78612,1.7,4571064,98.3,2987476,64.3,1542305,33.2,55634,1.2,93522,2,5161,0.1,52801,1.1
2014,Maine,1330089,647622,48.7,682467,51.3,1072117,1072117,517153,48.2,554964,51.8,27502,2.1,1302587,97.9,1286809,96.7,22945,1.7,24228,1.8,21078,1.6,509,0,3904,0.3
2014,Maryland,5976407,2896033,48.5,3080374,51.5,4625232,4625232,2205615,47.7,2419617,52.3,173007,2.9,5803400,97.1,3569832,59.7,1866387,31.2,61256,1,428885,7.2,8137,0.1,232319,3.9
2014,Massachusetts,6745408,3269679,48.5,3475729,51.5,5354723,5354723,2559791,47.8,2794932,52.2,210526,3.1,6534882,96.9,5536189,82.1,593757,8.8,48497,0.7,468916,7,8974,0.1,314105,4.7
2014,Michigan,9909877,4865257,49.1,5044620,50.9,7686241,7686241,3727609,48.5,3958632,51.5,256845,2.6,9653032,97.4,8045636,81.2,1506987,15.2,146002,1.5,336731,3.4,9226,0.1,146017,1.5
2014,Minnesota,5457173,2712823,49.7,2744350,50.3,4174065,4174065,2055803,49.3,2118262,50.7,143035,2.6,5314138,97.4,4739703,86.9,373589,6.8,102323,1.9,292515,5.4,6595,0.1,97544,1.8
2014,Mississippi,2994079,1457828,48.7,1536251,51.3,2261526,2261526,1080034,47.8,1181492,52.2,38343,1.3,2955736,98.7,1794738,59.9,1153529,38.5,22628,0.8,31733,1.1,2903,0.1,28803,1
2014,Missouri,6063589,2970513,49,3093076,51,4671087,4671087,2259225,48.4,2411862,51.6,150461,2.5,5913128,97.5,5126993,84.6,776892,12.8,79091,1.3,139614,2.3,11876,0.2,88456,1.5
2014,Montana,1023579,513409,50.2,510170,49.8,798957,798957,398149,49.8,400808,50.2,21853,2.1,1001726,97.9,935492,91.4,9638,0.9,81795,8,14042,1.4,1298,0.1,4034,0.4
2014,Nebraska,1881503,936197,49.8,945306,50.2,1413626,1413626,695420,49.2,718206,50.8,43905,2.3,1837598,97.7,1700619,90.4,107378,5.7,34983,1.9,47903,2.5,2919,0.2,34839,1.9
2014,Nevada,2839099,1426744,50.3,1412355,49.7,2176568,2176568,1087062,49.9,1089506,50.1,125148,4.4,2713951,95.6,2029269,71.5,283045,10,53857,1.9,280878,9.9,38635,1.4,290275,10.2
2014,New Hampshire,1326813,654814,49.4,671999,50.6,1059527,1059527,518557,48.9,540970,51.1,27392,2.1,1299421,97.9,1264553,95.3,26510,2,11043,0.8,41187,3.1,2171,0.2,10756,0.8
2014,New Jersey,8938175,4363391,48.8,4574784,51.2,6925978,6925978,3335466,48.2,3590512,51.8,205908,2.3,8732267,97.7,6211213,69.5,1312644,14.7,54381,0.6,896533,10,11251,0.1,674112,7.5
2014,New Mexico,2085572,1032779,49.5,1052793,50.5,1585494,1585494,778144,49.1,807350,50.9,63408,3,2022164,97,1572325,75.4,53302,2.6,217607,10.4,52720,2.5,1833,0.1,254885,12.2
2014,New York,19746227,9574309,48.5,10171918,51.5,15520954,15520954,7417983,47.8,8102971,52.2,572418,2.9,19173809,97.1,13073577,66.2,3380875,17.1,217940,1.1,1779926,9,23803,0.1,1900131,9.6
2014,North Carolina,9943964,4842403,48.7,5101561,51.3,7653396,7653396,3670458,48,3982938,52,234354,2.4,9709610,97.6,7071372,71.1,2284464,23,178543,1.8,297715,3,13957,0.1,354100,3.6
2014,North Dakota,739482,376324,50.9,363158,49.1,571956,571956,291833,51,280123,49,16776,2.3,722706,97.7,669224,90.5,18357,2.5,51139,6.9,11914,1.6,978,0.1,5691,0.8
2014,Ohio,11594163,5676586,49,5917577,51,8958523,8958523,4325168,48.3,4633355,51.7,297875,2.6,11296288,97.4,9796575,84.5,1596867,13.8,95887,0.8,280265,2.4,10172,0.1,134957,1.2
2014,Oklahoma,3878051,1920562,49.5,1957489,50.5,2925758,2925758,1430242,48.9,1495516,51.1,297948,7.7,3580103,92.3,3098252,79.9,351334,9.1,523396,13.5,97472,2.5,7687,0.2,111742,2.9
2014,Oregon,3970239,1964293,49.5,2005946,50.5,3111524,3111524,1524999,49,1586525,51,178680,4.5,3791559,95.5,3517452,88.6,107034,2.7,126944,3.2,218533,5.5,32537,0.8,162947,4.1
2014,Pennsylvania,12787209,6253250,48.9,6533959,51.1,10087031,10087031,4872663,48.3,5214368,51.7,289157,2.3,12498052,97.7,10661042,83.4,1580003,12.4,107010,0.8,461541,3.6,14191,0.1,278661,2.2
2014,Puerto Rico,3548397,1704416,48,1843981,52,2775652,2775652,1301376,46.9,1474276,53.1,226813,6.4,3321584,93.6,2737730,77.2,500692,14.1,41924,1.2,10370,0.3,875,0,503344,14.2
2014,Rhode Island,1055173,511650,48.5,543523,51.5,842618,842618,402481,47.8,440137,52.2,27335,2.6,1027838,97.4,878104,83.2,84428,8,12596,1.2,42499,4,1357,0.1,65520,6.2
2014,South Carolina,4832482,2351359,48.7,2481123,51.3,3748798,3748798,1798027,48,1950771,52,102357,2.1,4730125,97.9,3342896,69.2,1381957,28.6,46364,1,87746,1.8,5979,0.1,77767,1.6
2014,South Dakota,853175,427381,50.1,425794,49.9,642282,642282,319592,49.8,322690,50.2,23533,2.8,829642,97.2,747070,87.6,20603,2.4,86570,10.1,14278,1.7,1056,0.1,8059,0.9
2014,Tennessee,6549352,3190199,48.7,3359153,51.3,5057015,5057015,2428281,48,2628734,52,137465,2.1,6411887,97.9,5206947,79.5,1169806,17.9,64346,1,131375,2,11277,0.2,112954,1.7
2014,Texas,26956958,13384317,49.7,13572641,50.3,19841122,19841122,9748103,49.1,10093019,50.9,663713,2.5,26293245,97.5,20837327,77.3,3489082,12.9,321046,1.2,1339741,5,47236,0.2,1637026,6.1
2014,Utah,2942902,1479527,50.3,1463375,49.7,2037353,2037353,1013087,49.7,1024266,50.3,78495,2.7,2864407,97.3,2638981,89.7,48255,1.6,53278,1.8,92735,3.2,40393,1.4,153682,5.2
2014,Vermont,626562,308516,49.2,318046,50.8,504752,504752,245401,48.6,259351,51.4,12862,2.1,613700,97.9,603784,96.4,9550,1.5,9398,1.5,12620,2,1754,0.3,3149,0.5
2014,Virginia,8326289,4092671,49.2,4233618,50.8,6458752,6458752,3140049,48.6,3318703,51.4,273629,3.3,8052660,96.7,5971372,71.7,1736828,20.9,78758,0.9,612749,7.4,15233,0.2,206907,2.5
2014,Washington,7061530,3529597,50,3531933,50,5458877,5458877,2709361,49.6,2749516,50.4,382973,5.4,6678557,94.6,5828890,82.5,371594,5.3,216215,3.1,703753,10,77523,1.1,289616,4.1
2014,West Virginia,1850326,914686,49.4,935640,50.6,1467126,1467126,717964,48.9,749162,51.1,30753,1.7,1819573,98.3,1760520,95.1,86018,4.6,11057,0.6,17283,0.9,1244,0.1,6701,0.4
2014,Wisconsin,5757564,2857982,49.6,2899582,50.4,4458062,4458062,2194015,49.2,2264047,50.8,119374,2.1,5638190,97.9,5075794,88.2,415480,7.2,93779,1.6,174987,3,4384,0.1,120392,2.1
2014,Wyoming,584153,297181,50.9,286972,49.1,446389,446389,226674,50.8,219715,49.2,12894,2.2,571259,97.8,544030,93.1,9256,1.6,22197,3.8,7442,1.3,1625,0.3,13763,2.4
2015,Alabama,4858979,2352810,48.4,2506169,51.6,3750571,3750571,1787162,47.7,1963409,52.3,87319,1.8,4771660,98.2,3408924,70.2,1340849,27.6,56591,1.2,77232,1.6,7944,0.2,61172,1.3
2015,Alaska,738432,388695,52.6,349737,47.4,552041,552041,292599,53,259442,47,63285,8.6,675147,91.4,537520,72.8,36682,5,143696,19.5,60787,8.2,11184,1.5,15785,2.1
2015,Arizona,6828065,3387385,49.6,3440680,50.4,5206537,5206537,2561598,49.2,2644939,50.8,222446,3.3,6605619,96.7,5479838,80.3,374345,5.5,376636,5.5,281822,4.1,24649,0.4,530418,7.8
2015,Arkansas,2978204,1463576,49.1,1514628,50.9,2272260,2272260,1099264,48.4,1172996,51.6,64220,2.2,2913984,97.8,2367749,79.5,493907,16.6,49092,1.6,52597,1.8,9777,0.3,71843,2.4
2015,California,39144818,19440558,49.7,19704260,50.3,30028400,30028400,14786858,49.2,15241542,50.8,1753771,4.5,37391047,95.5,25281871,64.6,2718375,6.9,721345,1.8,6319520,16.1,307513,0.8,5717277,14.6
2015,Colorado,5456574,2741020,50.2,2715554,49.8,4199802,4199802,2100215,50,2099587,50,193331,3.5,5263243,96.5,4779809,87.6,282935,5.2,109913,2,228381,4.2,20630,0.4,243879,4.5
2015,Connecticut,3590886,1752063,48.8,1838823,51.2,2827561,2827561,1360885,48.1,1466676,51.9,116604,3.2,3474282,96.8,2843798,79.2,436476,12.2,39433,1.1,185175,5.2,4142,0.1,210801,5.9
2015,Delaware,945934,458208,48.4,487726,51.6,741734,741734,353963,47.7,387771,52.3,28441,3,917493,97,678389,71.7,223502,23.6,9044,1,41381,4.4,1196,0.1,22956,2.4
2015,Florida,20271272,9891238,48.8,10380034,51.2,16168283,16168283,7803581,48.3,8364702,51.7,501856,2.5,19769416,97.5,15778906,77.8,3519337,17.4,158032,0.8,693333,3.4,38292,0.2,624518,3.1
2015,Georgia,10214860,4975458,48.7,5239402,51.3,7712446,7712446,3695751,47.9,4016695,52.1,234124,2.3,9980736,97.7,6269985,61.4,3323239,32.5,86060,0.8,453174,4.4,15060,0.1,323321,3.2
2015,Hawaii,1431603,724635,50.6,706968,49.4,1120397,1120397,566130,50.5,554267,49.5,350173,24.5,1081430,75.5,634619,44.3,53380,3.7,41333,2.9,797698,55.7,370528,25.9,25758,1.8
2015,Idaho,1654930,826819,50,828111,50,1222749,1222749,605560,49.5,617189,50.5,47424,2.9,1607506,97.1,1560174,94.3,15731,1,40640,2.5,38205,2.3,8112,0.5,43896,2.7
2015,Illinois,12859995,6310435,49.1,6549560,50.9,9899810,9899810,4801668,48.5,5098142,51.5,295465,2.3,12564530,97.7,9494405,73.8,1968905,15.3,89444,0.7,777208,6,14515,0.1,833770,6.5
2015,Indiana,6619680,3253089,49.1,3366591,50.9,5039946,5039946,2448618,48.6,2591328,51.4,156739,2.4,6462941,97.6,5703273,86.2,696966,10.5,52961,0.8,165387,2.5,6273,0.1,160334,2.4
2015,Iowa,3123899,1549289,49.6,1574610,50.4,2395146,2395146,1177143,49.1,1218003,50.9,59872,1.9,3064027,98.1,2882628,92.3,138029,4.4,22826,0.7,84681,2.7,5359,0.2,52539,1.7
2015,Kansas,2911641,1449224,49.8,1462417,50.2,2191407,2191407,1081924,49.4,1109483,50.6,92999,3.2,2818642,96.8,2551918,87.6,215623,7.4,61495,2.1,100098,3.4,5398,0.2,76412,2.6
2015,Kentucky,4425092,2174892,49.1,2250200,50.9,3414509,3414509,1658306,48.6,1756203,51.4,94235,2.1,4330857,97.9,3953589,89.3,412464,9.3,34897,0.8,74640,1.7,6488,0.1,45298,1
2015,Louisiana,4670724,2286299,48.9,2384425,51.1,3554539,3554539,1711452,48.1,1843087,51.9,97673,2.1,4573051,97.9,3002112,64.3,1556967,33.3,58926,1.3,95262,2,3486,0.1,62474,1.3
2015,Maine,1329328,651030,49,678298,51,1073469,1073469,518899,48.3,554570,51.7,30593,2.3,1298735,97.7,1287136,96.8,22545,1.7,25532,1.9,20439,1.5,1676,0.1,4223,0.3
2015,Maryland,6006401,2912348,48.5,3094053,51.5,4658669,4658669,2223758,47.7,2434911,52.3,187294,3.1,5819107,96.9,3544608,59,1883491,31.4,59795,1,441156,7.3,12743,0.2,272271,4.5
2015,Massachusetts,6794422,3297384,48.5,3497038,51.5,5407228,5407228,2587786,47.9,2819442,52.1,198384,2.9,6596038,97.1,5545771,81.6,604736,8.9,46695,0.7,484698,7.1,7469,0.1,315213,4.6
2015,Michigan,9922576,4877067,49.2,5045509,50.8,7714752,7714752,3748128,48.6,3966624,51.4,271937,2.7,9650639,97.3,8045257,81.1,1516515,15.3,146158,1.5,347028,3.5,11018,0.1,149495,1.5
2015,Minnesota,5489594,2730030,49.7,2759564,50.3,4206696,4206696,2071636,49.2,2135060,50.8,155738,2.8,5333856,97.2,4755804,86.6,385570,7,106485,1.9,306221,5.6,8141,0.1,96084,1.8
2015,Mississippi,2992333,1448495,48.4,1543838,51.6,2264326,2264326,1079190,47.7,1185136,52.3,35860,1.2,2956473,98.8,1789250,59.8,1150730,38.5,21587,0.7,36422,1.2,3131,0.1,30624,1
2015,Missouri,6083672,2983645,49,3100027,51,4691106,4691106,2271360,48.4,2419746,51.6,149866,2.5,5933806,97.5,5147349,84.6,781643,12.8,77577,1.3,145800,2.4,14866,0.2,79101,1.3
2015,Montana,1032949,519026,50.2,513923,49.8,806722,806722,403584,50,403138,50,27170,2.6,1005779,97.4,944642,91.5,9857,1,83633,8.1,12973,1.3,2423,0.2,8214,0.8
2015,Nebraska,1896190,942589,49.7,953601,50.3,1425560,1425560,702111,49.3,723449,50.7,43714,2.3,1852476,97.7,1712226,90.3,109846,5.8,30154,1.6,51791,2.7,2442,0.1,35793,1.9
2015,Nevada,2890845,1447456,50.1,1443389,49.9,2222290,2222290,1107329,49.8,1114961,50.2,143566,5,2747279,95,2070722,71.6,296181,10.2,59996,2.1,293713,10.2,36030,1.2,294069,10.2
2015,New Hampshire,1330608,657716,49.4,672892,50.6,1067277,1067277,522908,49,544369,51,22562,1.7,1308046,98.3,1266719,95.2,26916,2,11024,0.8,41490,3.1,986,0.1,6952,0.5
2015,New Jersey,8958013,4374892,48.8,4583121,51.2,6959148,6959148,3352396,48.2,3606752,51.8,243612,2.7,8714401,97.3,6245618,69.7,1328297,14.8,62676,0.7,928707,10.4,14851,0.2,646002,7.2
2015,New Mexico,2085109,1035143,49.6,1049966,50.4,1585693,1585693,779416,49.2,806277,50.8,70797,3.4,2014312,96.6,1585194,76,64448,3.1,219072,10.5,50685,2.4,2974,0.1,237715,11.4
2015,New York,19795791,9616592,48.6,10179199,51.4,15582624,15582624,7457463,47.9,8125161,52.1,581410,2.9,19214381,97.1,13066848,66,3366326,17,205301,1,1842941,9.3,30348,0.2,1918613,9.7
2015,North Carolina,10042802,4896006,48.8,5146796,51.2,7754752,7754752,3724425,48,4030327,52,241457,2.4,9801345,97.6,7139874,71.1,2312587,23,191314,1.9,323862,3.2,12926,0.1,330651,3.3
2015,North Dakota,756928,388152,51.3,368776,48.7,585614,585614,301058,51.4,284556,48.6,18934,2.5,737994,97.5,686249,90.7,20249,2.7,48325,6.4,13598,1.8,1540,0.2,6663,0.9
2015,Ohio,11613423,5683951,48.9,5929472,51.1,8983615,8983615,4338198,48.3,4645417,51.7,309331,2.7,11304092,97.3,9801177,84.4,1613348,13.9,103129,0.9,288581,2.5,10644,0.1,125291,1.1
2015,Oklahoma,3911338,1939555,49.6,1971783,50.4,2950241,2950241,1445485,49,1504756,51,309703,7.9,3601635,92.1,3120035,79.8,359551,9.2,521993,13.3,102422,2.6,7518,0.2,126530,3.2
2015,Oregon,4028977,1992162,49.4,2036815,50.6,3167825,3167825,1552453,49,1615372,51,182825,4.5,3846152,95.5,3606157,89.5,109403,2.7,129579,3.2,227243,5.6,29529,0.7,124070,3.1
2015,Pennsylvania,12802503,6262246,48.9,6540257,51.1,10110483,10110483,4883973,48.3,5226510,51.7,309371,2.4,12493132,97.6,10654845,83.2,1595789,12.5,95602,0.7,486424,3.8,14744,0.1,293119,2.3
2015,Puerto Rico,3474182,1657467,47.7,1816715,52.3,2736789,2736789,1277651,46.7,1459138,53.3,166946,4.8,3307236,95.2,2514340,72.4,490187,14.1,37301,1.1,9579,0.3,546,0,611550,17.6
2015,Rhode Island,1056298,511773,48.4,544525,51.6,844423,844423,403404,47.8,441019,52.2,36378,3.4,1019920,96.6,877004,83,84577,8,14361,1.4,44327,4.2,1407,0.1,73373,6.9
2015,South Carolina,4896146,2385096,48.7,2511050,51.3,3806838,3806838,1824107,47.9,1982731,52.1,103686,2.1,4792460,97.9,3380616,69,1403525,28.7,43112,0.9,90165,1.8,6031,0.1,81605,1.7
2015,South Dakota,858469,431540,50.3,426929,49.7,648789,648789,323230,49.8,325559,50.2,25397,3,833072,97,748750,87.2,18979,2.2,87202,10.2,16371,1.9,2138,0.2,11546,1.3
2015,Tennessee,6600299,3214689,48.7,3385610,51.3,5106499,5106499,2454974,48.1,2651525,51.9,140980,2.1,6459319,97.9,5259536,79.7,1180952,17.9,62284,0.9,135321,2.1,9273,0.1,104806,1.6
2015,Texas,27469114,13625413,49.6,13843701,50.4,20260330,20260330,9950860,49.1,10309470,50.9,691327,2.5,26777787,97.5,21186278,77.1,3555353,12.9,334261,1.2,1430104,5.2,48238,0.2,1654676,6
2015,Utah,2995919,1506383,50.3,1489536,49.7,2083586,2083586,1037467,49.8,1046119,50.2,86237,2.9,2909682,97.1,2689717,89.8,50884,1.7,59538,2,100135,3.3,41645,1.4,149159,5
2015,Vermont,626042,308552,49.3,317490,50.7,505882,505882,246808,48.8,259074,51.2,11149,1.8,614893,98.2,603996,96.5,10699,1.7,9109,1.5,11334,1.8,511,0.1,2368,0.4
2015,Virginia,8382993,4126326,49.2,4256667,50.8,6513179,6513179,3169806,48.7,3343373,51.3,296163,3.5,8086830,96.5,5975102,71.3,1753037,20.9,81379,1,637103,7.6,17921,0.2,239060,2.9
2015,Washington,7170351,3585221,50,3585130,50,5558381,5558381,2761352,49.7,2797029,50.3,397238,5.5,6773113,94.5,5860029,81.7,383372,5.3,210033,2.9,733099,10.2,88202,1.2,335773,4.7
2015,West Virginia,1844128,908559,49.3,935569,50.7,1464681,1464681,716850,48.9,747831,51.1,29461,1.6,1814667,98.4,1750327,94.9,89150,4.8,10932,0.6,17954,1,1553,0.1,5292,0.3
2015,Wisconsin,5771337,2868297,49.7,2903040,50.3,4479298,4479298,2205411,49.2,2273887,50.8,131701,2.3,5639636,97.7,5085631,88.1,420493,7.3,94573,1.6,184711,3.2,7762,0.1,119684,2.1
2015,Wyoming,586107,295102,50.3,291005,49.7,446607,446607,224295,50.2,222312,49.8,16335,2.8,569772,97.2,551803,94.1,9710,1.7,20497,3.5,8337,1.4,1465,0.2,12336,2.1
2016,Alabama,4863300,2356052,48.4,2507248,51.6,3763783,3763783,1790813,47.6,1972970,52.4,83858,1.7,4779442,98.3,3389735,69.7,1338854,27.5,56661,1.2,85704,1.8,3769,0.1,77234,1.6
2016,Alaska,741894,390573,52.6,351321,47.4,554598,554598,291298,52.5,263300,47.5,63961,8.6,677933,91.4,536380,72.3,37479,5.1,145982,19.7,61637,8.3,15903,2.1,15826,2.1
2016,Arizona,6931071,3444228,49.7,3486843,50.3,5299649,5299649,2611425,49.3,2688224,50.7,249680,3.6,6681391,96.4,5465822,78.9,384932,5.6,392975,5.7,289425,4.2,31883,0.5,643100,9.3
2016,Arkansas,2988248,1468782,49.2,1519466,50.8,2280888,2280888,1104604,48.4,1176284,51.6,77421,2.6,2910827,97.4,2358554,78.9,496098,16.6,53548,1.8,53699,1.8,11608,0.4,97373,3.3
2016,California,39250017,19491231,49.7,19758786,50.3,30156768,30156768,14848286,49.2,15308482,50.8,1879650,4.8,37370367,95.2,24980439,63.6,2758577,7,746753,1.9,6432756,16.4,319337,0.8,6074661,15.5
2016,Colorado,5540545,2790701,50.4,2749844,49.6,4280033,4280033,2140793,50,2139240,50,184361,3.3,5356184,96.7,4821075,87,296883,5.4,113874,2.1,229940,4.2,17506,0.3,263483,4.8
2016,Connecticut,3576452,1745153,48.8,1831299,51.2,2824290,2824290,1360390,48.2,1463900,51.8,111524,3.1,3464928,96.9,2830366,79.1,441437,12.3,38558,1.1,190086,5.3,4062,0.1,196716,5.5
2016,Delaware,952065,460232,48.3,491833,51.7,747828,747828,356682,47.7,391146,52.3,25714,2.7,926351,97.3,679963,71.4,225488,23.7,10179,1.1,43419,4.6,2820,0.3,17792,1.9
2016,Florida,20612439,10070860,48.9,10541579,51.1,16467299,16467299,7951948,48.3,8515351,51.7,532751,2.6,20079688,97.4,16027408,77.8,3583291,17.4,167446,0.8,708195,3.4,42968,0.2,664982,3.2
2016,Georgia,10310371,5018150,48.7,5292221,51.3,7799761,7799761,3735972,47.9,4063789,52.1,258456,2.5,10051915,97.5,6263135,60.7,3401427,33,103846,1,471515,4.6,17918,0.2,341350,3.3
2016,Hawaii,1428557,718057,50.3,710500,49.7,1120792,1120792,559533,49.9,561259,50.1,341679,23.9,1086878,76.1,613488,42.9,49512,3.5,33315,2.3,810627,56.7,371680,26,30329,2.1
2016,Idaho,1683140,841203,50,841937,50,1246683,1246683,616842,49.5,629841,50.5,42070,2.5,1641070,97.5,1548224,92,18885,1.1,42982,2.6,38289,2.3,5946,0.4,73268,4.4
2016,Illinois,12801539,6289724,49.1,6511815,50.9,9878820,9878820,4796996,48.6,5081824,51.4,321411,2.5,12480128,97.5,9402346,73.4,1950134,15.2,98929,0.8,786820,6.1,15061,0.1,895742,7
2016,Indiana,6633053,3267337,49.3,3365716,50.7,5055520,5055520,2458014,48.6,2597506,51.4,158643,2.4,6474410,97.6,5685793,85.7,704428,10.6,50494,0.8,172555,2.6,8155,0.1,177946,2.7
2016,Iowa,3134693,1556668,49.7,1578025,50.3,2407726,2407726,1183019,49.1,1224707,50.9,57293,1.8,3077400,98.2,2887953,92.1,142363,4.5,25409,0.8,87194,2.8,5904,0.2,46455,1.5
2016,Kansas,2907289,1448853,49.8,1458436,50.2,2192370,2192370,1081183,49.3,1111187,50.7,103366,3.6,2803923,96.4,2554809,87.9,211231,7.3,62907,2.2,100795,3.5,6667,0.2,83646,2.9
2016,Kentucky,4436974,2179814,49.1,2257160,50.9,3424517,3424517,1661682,48.5,1762835,51.5,92135,2.1,4344839,97.9,3951092,89,420332,9.5,32270,0.7,77104,1.7,3886,0.1,48015,1.1
2016,Louisiana,4681666,2291880,49,2389786,51,3564385,3564385,1719143,48.2,1845242,51.8,92749,2,4588917,98,2984864,63.8,1563466,33.4,63061,1.3,93530,2,2995,0.1,76949,1.6
2016,Maine,1331479,650702,48.9,680777,51.1,1076528,1076528,520512,48.4,556016,51.6,26340,2,1305139,98,1282395,96.3,26592,2,21517,1.6,23732,1.8,1668,0.1,3256,0.2
2016,Maryland,6016447,2917773,48.5,3098674,51.5,4670295,4670295,2228185,47.7,2442110,52.3,201041,3.3,5815406,96.7,3557526,59.1,1903321,31.6,58850,1,449268,7.5,11852,0.2,254887,4.2
2016,Massachusetts,6811779,3305817,48.5,3505962,51.5,5432832,5432832,2601274,47.9,2831558,52.1,212365,3.1,6599414,96.9,5536798,81.3,627509,9.2,46254,0.7,500157,7.3,11125,0.2,318688,4.7
2016,Michigan,9928300,4883220,49.2,5045080,50.8,7737117,7737117,3763553,48.6,3973564,51.4,306220,3.1,9622080,96.9,8068217,81.3,1514424,15.3,157645,1.6,362199,3.6,9838,0.1,148293,1.5
2016,Minnesota,5519952,2747946,49.8,2772006,50.2,4231329,4231329,2087052,49.3,2144277,50.7,156646,2.8,5363306,97.2,4738455,85.8,399885,7.2,106393,1.9,310723,5.6,6487,0.1,127686,2.3
2016,Mississippi,2988726,1440934,48.2,1547792,51.8,2265573,2265573,1075388,47.5,1190185,52.5,33852,1.1,2954874,98.9,1778264,59.5,1153632,38.6,24589,0.8,33524,1.1,2039,0.1,33014,1.1
2016,Missouri,6093000,2994651,49.1,3098349,50.9,4702936,4702936,2280183,48.5,2422753,51.5,150100,2.5,5942900,97.5,5150148,84.5,777140,12.8,80414,1.3,151203,2.5,13108,0.2,81542,1.3
2016,Montana,1042520,526023,50.5,516497,49.5,813846,813846,406644,50,407202,50,32218,3.1,1010302,96.9,957640,91.9,9759,0.9,87763,8.4,14044,1.3,2254,0.2,5395,0.5
2016,Nebraska,1907116,950124,49.8,956992,50.2,1433031,1433031,708362,49.4,724669,50.6,45386,2.4,1861730,97.6,1715506,90,111022,5.8,29023,1.5,54283,2.8,3794,0.2,42165,2.2
2016,Nevada,2940058,1473153,50.1,1466905,49.9,2262556,2262556,1126972,49.8,1135584,50.2,139202,4.7,2800856,95.3,2077679,70.7,306810,10.4,63485,2.2,305678,10.4,40951,1.4,299543,10.2
2016,New Hampshire,1334795,664722,49.8,670073,50.2,1074954,1074954,529482,49.3,545472,50.7,28717,2.2,1306078,97.8,1274258,95.5,26478,2,10205,0.8,42487,3.2,639,0,10887,0.8
2016,New Jersey,8944469,4370211,48.9,4574258,51.1,6960030,6960030,3355381,48.2,3604649,51.8,237326,2.7,8707143,97.3,6278080,70.2,1315079,14.7,59227,0.7,935236,10.5,11348,0.1,606064,6.8
2016,New Mexico,2081015,1030224,49.5,1050791,50.5,1591501,1591501,780393,49,811108,51,65905,3.2,2015110,96.8,1594339,76.6,55675,2.7,220136,10.6,46208,2.2,2977,0.1,232503,11.2
2016,New York,19745289,9582050,48.5,10163239,51.5,15565903,15565903,7446482,47.8,8119421,52.2,616861,3.1,19128428,96.9,13006279,65.9,3389796,17.2,197369,1,1864781,9.4,30833,0.2,1928061,9.8
2016,North Carolina,10146788,4933381,48.6,5213407,51.4,7849894,7849894,3756375,47.9,4093519,52.1,268866,2.6,9877922,97.4,7210722,71.1,2337481,23,205112,2,336661,3.3,17209,0.2,333531,3.3
2016,North Dakota,757953,390181,51.5,367772,48.5,583358,583358,299206,51.3,284152,48.7,21588,2.8,736365,97.2,681403,89.9,22571,3,53166,7,13470,1.8,1887,0.2,8007,1.1
2016,Ohio,11614373,5691600,49,5922773,51,9005402,9005402,4359708,48.4,4645694,51.6,324432,2.8,11289941,97.2,9769334,84.1,1644622,14.2,94297,0.8,305150,2.6,12117,0.1,137866,1.2
2016,Oklahoma,3923561,1943273,49.5,1980288,50.5,2961605,2961605,1448149,48.9,1513456,51.1,303606,7.7,3619955,92.3,3120274,79.5,356787,9.1,523624,13.3,105872,2.7,12053,0.3,124081,3.2
2016,Oregon,4093465,2026038,49.5,2067427,50.5,3225219,3225219,1581932,49,1643287,51,207593,5.1,3885872,94.9,3649771,89.2,116114,2.8,141215,3.4,235801,5.8,36313,0.9,139013,3.4
2016,Pennsylvania,12784227,6262870,49,6521357,51,10109382,10109382,4892729,48.4,5216653,51.6,323754,2.5,12460473,97.5,10618697,83.1,1599908,12.5,103259,0.8,493781,3.9,12659,0.1,307169,2.4
2016,Puerto Rico,3411307,1625567,47.7,1785740,52.3,2715431,2715431,1266884,46.7,1448547,53.3,147855,4.3,3263452,95.7,2418354,70.9,527165,15.5,22359,0.7,8025,0.2,542,0,593471,17.4
2016,Rhode Island,1056426,511358,48.4,545068,51.6,847786,847786,404848,47.8,442938,52.2,32887,3.1,1023539,96.9,873134,82.6,86467,8.2,15512,1.5,44090,4.2,3529,0.3,71037,6.7
2016,South Carolina,4961119,2405343,48.5,2555776,51.5,3861155,3861155,1843725,47.8,2017430,52.2,108096,2.2,4853023,97.8,3437291,69.3,1402857,28.3,45517,0.9,98824,2,5573,0.1,88354,1.8
2016,South Dakota,865454,435668,50.3,429786,49.7,651553,651553,324744,49.8,326809,50.2,21548,2.5,843906,97.5,753376,87,20501,2.4,89660,10.4,15830,1.8,1708,0.2,7531,0.9
2016,Tennessee,6651194,3247058,48.8,3404136,51.2,5147942,5147942,2473357,48,2674585,52,139850,2.1,6511344,97.9,5304196,79.7,1187342,17.9,62086,0.9,143549,2.2,9947,0.1,92283,1.4
2016,Texas,27862596,13830953,49.6,14031643,50.4,20570902,20570902,10107352,49.1,10463550,50.9,714714,2.6,27147882,97.4,21310714,76.5,3642426,13.1,350974,1.3,1493998,5.4,51563,0.2,1777528,6.4
2016,Utah,3051217,1538145,50.4,1513072,49.6,2129370,2129370,1063819,50,1065551,50,89044,2.9,2962173,97.1,2713804,88.9,51667,1.7,52223,1.7,104864,3.4,44861,1.5,180460,5.9
2016,Vermont,624594,307874,49.3,316720,50.7,505910,505910,246774,48.8,259136,51.2,12324,2,612270,98,600733,96.2,11314,1.8,7972,1.3,13419,2.1,664,0.1,3789,0.6
2016,Virginia,8411808,4135485,49.2,4276323,50.8,6544248,6544248,3180665,48.6,3363583,51.4,310423,3.7,8101385,96.3,5966699,70.9,1762171,20.9,86426,1,649343,7.7,21721,0.3,266541,3.2
2016,Washington,7288000,3639726,49.9,3648274,50.1,5658939,5658939,2806590,49.6,2852349,50.4,414136,5.7,6873864,94.3,5883913,80.7,394194,5.4,220683,3,768828,10.5,88387,1.2,393564,5.4
2016,West Virginia,1831102,900913,49.2,930189,50.8,1454219,1454219,709917,48.8,744302,51.2,31304,1.7,1799798,98.3,1734107,94.7,86436,4.7,13504,0.7,20498,1.1,1515,0.1,9273,0.5
2016,Wisconsin,5778709,2872921,49.7,2905788,50.3,4493718,4493718,2215906,49.3,2277812,50.7,140330,2.4,5638379,97.6,5070065,87.7,428940,7.4,93580,1.6,186501,3.2,6098,0.1,144989,2.5
2016,Wyoming,585501,298205,50.9,287296,49.1,444641,444641,226138,50.9,218503,49.1,15304,2.6,570197,97.4,552516,94.4,10544,1.8,20025,3.4,9999,1.7,1248,0.2,7949,1.4
2017,Alabama,4874747,2359896,48.4,2514851,51.6,3780686,3780686,1799902,47.6,1980784,52.4,93584,1.9,4781163,98.1,3395370,69.7,1356161,27.8,59414,1.2,83555,1.7,3573,0.1,77543,1.6
2017,Alaska,739795,385776,52.1,354019,47.9,554614,554614,291715,52.6,262899,47.4,63390,8.6,676405,91.4,531861,71.9,34537,4.7,150704,20.4,63830,8.6,12626,1.7,15089,2
2017,Arizona,7016270,3487722,49.7,3528548,50.3,5383542,5383542,2655396,49.3,2728146,50.7,266401,3.8,6749869,96.2,5666683,80.8,399987,5.7,404869,5.8,302879,4.3,36763,0.5,494491,7
2017,Arkansas,3004279,1479682,49.3,1524597,50.7,2295846,2295846,1114008,48.5,1181838,51.5,85169,2.8,2919110,97.2,2371107,78.9,490755,16.3,62037,2.1,59531,2,10922,0.4,98855,3.3
2017,California,39536653,19650051,49.7,19886602,50.3,30479267,30479267,15017561,49.3,15461706,50.7,1938077,4.9,37598576,95.1,24791383,62.7,2775059,7,778571,2,6634125,16.8,321326,0.8,6371342,16.1
2017,Colorado,5607154,2820169,50.3,2786985,49.7,4344795,4344795,2172597,50,2172198,50,193591,3.5,5413563,96.5,4892392,87.3,296260,5.3,120124,2.1,238802,4.3,19163,0.3,254201,4.5
2017,Connecticut,3588184,1750647,48.8,1837537,51.2,2845906,2845906,1370411,48.2,1475495,51.8,117503,3.3,3470681,96.7,2818010,78.5,445192,12.4,36406,1,195709,5.5,5397,0.2,220354,6.1
2017,Delaware,961939,465510,48.4,496429,51.6,757626,757626,361427,47.7,396199,52.3,29224,3,932715,97,686372,71.4,228746,23.8,9704,1,45593,4.7,1996,0.2,21250,2.2
2017,Florida,20984400,10254267,48.9,10730133,51.1,16783620,16783620,8114222,48.3,8669398,51.7,553886,2.6,20430514,97.4,16241493,77.4,3692327,17.6,178186,0.8,738196,3.5,35683,0.2,699040,3.3
2017,Georgia,10429379,5070721,48.6,5358658,51.4,7914614,7914614,3791307,47.9,4123307,52.1,286165,2.7,10143214,97.3,6356178,60.9,3448934,33.1,109189,1,496447,4.8,21875,0.2,313345,3
2017,Hawaii,1427538,716350,50.2,711188,49.8,1121541,1121541,558802,49.8,562739,50.2,331992,23.3,1095546,76.7,613156,43,52782,3.7,36274,2.5,797617,55.9,366803,25.7,38876,2.7
2017,Idaho,1716943,862720,50.2,854223,49.8,1273658,1273658,634918,49.8,638740,50.2,52711,3.1,1664232,96.9,1595391,92.9,20869,1.2,41730,2.4,42298,2.5,8608,0.5,66064,3.8
2017,Illinois,12802023,6294900,49.2,6507123,50.8,9906933,9906933,4815985,48.6,5090948,51.4,335471,2.6,12466552,97.4,9412790,73.5,1953739,15.3,96586,0.8,807418,6.3,16913,0.1,872133,6.8
2017,Indiana,6666818,3286152,49.3,3380666,50.7,5092787,5092787,2475148,48.6,2617639,51.4,177031,2.7,6489787,97.3,5739854,86.1,722316,10.8,49225,0.7,184791,2.8,8785,0.1,148320,2.2
2017,Iowa,3145711,1562265,49.7,1583446,50.3,2415361,2415361,1189067,49.2,1226294,50.8,67729,2.2,3077982,97.8,2892292,91.9,144803,4.6,27195,0.9,97395,3.1,7861,0.2,47189,1.5
2017,Kansas,2913123,1452573,49.9,1460550,50.1,2200548,2200548,1086615,49.4,1113933,50.6,101338,3.5,2811785,96.5,2555427,87.7,213694,7.3,59625,2,104469,3.6,7289,0.3,80836,2.8
2017,Kentucky,4454189,2194850,49.3,2259339,50.7,3439585,3439585,1671766,48.6,1767819,51.4,101523,2.3,4352666,97.7,3967120,89.1,422196,9.5,30074,0.7,85221,1.9,8162,0.2,50050,1.1
2017,Louisiana,4684333,2289695,48.9,2394638,51.1,3575091,3575091,1719776,48.1,1855315,51.9,86409,1.8,4597924,98.2,2967543,63.4,1573145,33.6,51898,1.1,100886,2.2,5465,0.1,82949,1.8
2017,Maine,1335907,654763,49,681144,51,1081705,1081705,524310,48.5,557395,51.5,30578,2.3,1305329,97.7,1290794,96.6,24268,1.8,25395,1.9,22169,1.7,968,0.1,4787,0.4
2017,Maryland,6052177,2935822,48.5,3116355,51.5,4705227,4705227,2247134,47.8,2458093,52.2,205316,3.4,5846861,96.6,3486980,57.6,1927464,31.8,63778,1.1,460022,7.6,11879,0.2,332229,5.5
2017,Massachusetts,6859819,3333270,48.6,3526549,51.4,5489235,5489235,2630513,47.9,2858722,52.1,209873,3.1,6649946,96.9,5570335,81.2,645572,9.4,44999,0.7,514718,7.5,10043,0.1,297097,4.3
2017,Michigan,9962311,4907242,49.3,5055069,50.7,7786450,7786450,3792561,48.7,3993889,51.3,294529,3,9667782,97,8073395,81,1522134,15.3,150627,1.5,375289,3.8,10447,0.1,146324,1.5
2017,Minnesota,5576606,2780714,49.9,2795892,50.1,4278824,4278824,2116447,49.5,2162377,50.5,158237,2.8,5418369,97.2,4753015,85.2,425197,7.6,110430,2,320526,5.7,7416,0.1,130498,2.3
2017,Mississippi,2984100,1446473,48.5,1537627,51.5,2269547,2269547,1079184,47.6,1190363,52.4,40431,1.4,2943669,98.6,1771426,59.4,1156352,38.8,25411,0.9,35433,1.2,3363,0.1,35832,1.2
2017,Missouri,6113532,3002694,49.1,3110838,50.9,4725871,4725871,2289651,48.4,2436220,51.6,161277,2.6,5952255,97.4,5162193,84.4,778856,12.7,81603,1.3,157945,2.6,13456,0.2,93311,1.5
2017,Montana,1050493,526357,50.1,524136,49.9,820598,820598,410107,50,410491,50,34098,3.2,1016395,96.8,962539,91.6,11152,1.1,84968,8.1,14681,1.4,2446,0.2,10677,1
2017,Nebraska,1920076,959273,50,960803,50,1445479,1445479,715308,49.5,730171,50.5,51228,2.7,1868848,97.3,1720851,89.6,115073,6,33754,1.8,58834,3.1,3092,0.2,43812,2.3
2017,Nevada,2998039,1506252,50.2,1491787,49.8,2314082,2314082,1154611,49.9,1159471,50.1,139203,4.6,2858836,95.4,2051354,68.4,318612,10.6,66328,2.2,316381,10.6,42137,1.4,359572,12
2017,New Hampshire,1342795,665741,49.6,677054,50.4,1084600,1084600,532324,49.1,552276,50.9,28109,2.1,1314686,97.9,1275613,95,31323,2.3,11758,0.9,44702,3.3,2338,0.2,6924,0.5
2017,New Jersey,9005644,4396848,48.8,4608796,51.2,7026848,7026848,3386625,48.2,3640223,51.8,229588,2.5,8776056,97.5,6295783,69.9,1332592,14.8,54873,0.6,966405,10.7,12369,0.1,593903,6.6
2017,New Mexico,2088070,1034144,49.5,1053926,50.5,1598348,1598348,785527,49.1,812821,50.9,69565,3.3,2018505,96.7,1640823,78.6,63684,3,228694,11,43609,2.1,3812,0.2,181155,8.7
2017,New York,19849399,9637896,48.6,10211503,51.4,15695902,15695902,7515307,47.9,8180595,52.1,602071,3,19247328,97,12978410,65.4,3436650,17.3,213702,1.1,1917511,9.7,30124,0.2,1933198,9.7
2017,North Carolina,10273419,4998538,48.7,5274881,51.3,7972229,7972229,3820732,47.9,4151497,52.1,266988,2.6,10006431,97.4,7292200,71,2357777,23,198836,1.9,357296,3.5,18906,0.2,341203,3.3
2017,North Dakota,755393,388300,51.4,367093,48.6,582257,582257,299237,51.4,283020,48.6,14787,2,740606,98,668285,88.5,26636,3.5,49144,6.5,16230,2.1,1187,0.2,9778,1.3
2017,Ohio,11658609,5709254,49,5949355,51,9056612,9056612,4377403,48.3,4679209,51.7,340980,2.9,11317629,97.1,9791347,84,1661333,14.2,96432,0.8,324372,2.8,14124,0.1,139955,1.2
2017,Oklahoma,3930864,1948986,49.6,1981878,50.4,2969381,2969381,1454053,49,1515328,51,302882,7.7,3627982,92.3,3114904,79.2,361077,9.2,527282,13.4,113995,2.9,12335,0.3,125343,3.2
2017,Oregon,4142776,2054016,49.6,2088760,50.4,3269002,3269002,1605612,49.1,1663390,50.9,198742,4.8,3944034,95.2,3682505,88.9,124365,3,126118,3,246369,5.9,34697,0.8,145987,3.5
2017,Pennsylvania,12805537,6272521,49,6533016,51,10140566,10140566,4905803,48.4,5234763,51.6,314432,2.5,12491105,97.5,10612867,82.9,1631167,12.7,90165,0.7,519346,4.1,13376,0.1,281240,2.2
2017,Puerto Rico,3337177,1591997,47.7,1745180,52.3,2680383,2680383,1246643,46.5,1433740,53.5,175818,5.3,3161359,94.7,2378421,71.3,563738,16.9,23962,0.7,7783,0.2,408,0,552176,16.5
2017,Rhode Island,1059639,513198,48.4,546441,51.6,852667,852667,407807,47.8,444860,52.2,34652,3.3,1024987,96.7,893147,84.3,83646,7.9,14290,1.3,47457,4.5,1763,0.2,56403,5.3
2017,South Carolina,5024369,2436902,48.5,2587467,51.5,3922649,3922649,1875631,47.8,2047018,52.2,107229,2.1,4917140,97.9,3474484,69.2,1415272,28.2,47694,0.9,100518,2,8662,0.2,92392,1.8
2017,South Dakota,869666,438429,50.4,431237,49.6,656438,656438,329648,50.2,326790,49.8,22654,2.6,847012,97.4,757419,87.1,23490,2.7,89584,10.3,14959,1.7,1384,0.2,6936,0.8
2017,Tennessee,6715984,3272135,48.7,3443849,51.3,5207732,5207732,2506343,48.1,2701389,51.9,142326,2.1,6573658,97.9,5349262,79.6,1198891,17.9,52698,0.8,151488,2.3,14975,0.2,100480,1.5
2017,Texas,28304596,14062701,49.7,14241895,50.3,20939433,20939433,10298806,49.2,10640627,50.8,749080,2.6,27555516,97.4,21574047,76.2,3712453,13.1,332793,1.2,1571986,5.6,61902,0.2,1858983,6.6
2017,Utah,3101833,1563433,50.4,1538400,49.6,2176739,2176739,1086466,49.9,1090273,50.1,92276,3,3009557,97,2739608,88.3,54113,1.7,52640,1.7,110671,3.6,48177,1.6,199392,6.4
2017,Vermont,623657,307810,49.4,315847,50.6,505902,505902,246999,48.8,258903,51.2,12949,2.1,610708,97.9,600010,96.2,13044,2.1,6883,1.1,14633,2.3,446,0.1,2086,0.3
2017,Virginia,8470020,4163754,49.2,4306266,50.8,6601939,6601939,3210622,48.6,3391317,51.4,331386,3.9,8138634,96.1,6006069,70.9,1795098,21.2,95296,1.1,671849,7.9,17004,0.2,255069,3
2017,Washington,7405743,3698615,49.9,3707128,50.1,5759010,5759010,2859698,49.7,2899312,50.3,438085,5.9,6967658,94.1,5975019,80.7,404766,5.5,223788,3,804163,10.9,93660,1.3,390921,5.3
2017,West Virginia,1815857,897166,49.4,918691,50.6,1442454,1442454,705573,48.9,736881,51.1,30524,1.7,1785333,98.3,1713049,94.3,92106,5.1,9362,0.5,18376,1,613,0,15356,0.8
2017,Wisconsin,5795483,2880454,49.7,2915029,50.3,4516122,4516122,2228211,49.3,2287911,50.7,143237,2.5,5652246,97.5,5073303,87.5,433227,7.5,95034,1.6,190025,3.3,7911,0.1,148669,2.6
2017,Wyoming,579315,295779,51.1,283536,48.9,441253,441253,224212,50.8,217041,49.2,16350,2.8,562965,97.2,544335,94,10600,1.8,20840,3.6,8863,1.5,1537,0.3,12277,2.1
2018,Alabama,4887871,2369271,48.5,2518600,51.5,3798766,3798766,1805236,47.5,1993530,52.5,101011,2.1,4786860,97.9,3394273,69.4,1349621,27.6,62780,1.3,89230,1.8,5925,0.1,93147,1.9
2018,Alaska,737438,382952,51.9,354486,48.1,553978,553978,289766,52.3,264212,47.7,62196,8.4,675242,91.6,529846,71.8,36659,5,149430,20.3,63855,8.7,14092,1.9,13875,1.9
2018,Arizona,7171646,3565129,49.7,3606517,50.3,5529647,5529647,2726338,49.3,2803309,50.7,286980,4,6884666,96,5838911,81.4,432062,6,424955,5.9,322251,4.5,32684,0.5,429942,6
2018,Arkansas,3013825,1476680,49,1537145,51,2309865,2309865,1118983,48.4,1190882,51.6,88201,2.9,2925624,97.1,2387735,79.2,487767,16.2,63583,2.1,60225,2,13359,0.4,92978,3.1
2018,California,39557045,19673553,49.7,19883492,50.3,30571507,30571507,15074187,49.3,15497320,50.7,2004462,5.1,37552583,94.9,25188735,63.7,2788457,7,799889,2,6717391,17,333780,0.8,5943787,15
2018,Colorado,5695564,2864761,50.3,2830803,49.7,4428826,4428826,2215430,50,2213396,50,227470,4,5468094,96,4997140,87.7,311745,5.5,126983,2.2,254210,4.5,19880,0.3,237478,4.2
2018,Connecticut,3572665,1740533,48.7,1832132,51.3,2837599,2837599,1367138,48.2,1470461,51.8,121390,3.4,3451275,96.6,2787851,78,461513,12.9,35881,1,195312,5.5,6283,0.2,220518,6.2
2018,Delaware,967171,467924,48.4,499247,51.6,764021,764021,365181,47.8,398840,52.2,25828,2.7,941343,97.3,681901,70.5,234961,24.3,10015,1,45175,4.7,1338,0.1,22505,2.3
2018,Florida,21299325,10404676,48.8,10894649,51.2,17071450,17071450,8246984,48.3,8824466,51.7,613925,2.9,20685400,97.1,16428821,77.1,3731939,17.5,171405,0.8,774567,3.6,43479,0.2,818951,3.8
2018,Georgia,10519475,5120290,48.7,5399185,51.3,8016182,8016182,3835526,47.8,4180656,52.2,286406,2.7,10233069,97.3,6365137,60.5,3487272,33.2,92014,0.9,509357,4.8,26155,0.2,348034,3.3
2018,Hawaii,1420491,710702,50,709789,50,1117236,1117236,556287,49.8,560949,50.2,345775,24.3,1074716,75.7,600675,42.3,53844,3.8,30383,2.1,807332,56.8,383172,27,45189,3.2
2018,Idaho,1754208,882158,50.3,872050,49.7,1308838,1308838,652254,49.8,656584,50.2,53255,3,1700953,97,1626499,92.7,22173,1.3,41448,2.4,45610,2.6,7162,0.4,71096,4.1
2018,Illinois,12741080,6266062,49.2,6475018,50.8,9885278,9885278,4801941,48.6,5083337,51.4,340977,2.7,12400103,97.3,9431680,74,1952694,15.3,100555,0.8,831487,6.5,16444,0.1,776129,6.1
2018,Indiana,6691878,3295973,49.3,3395905,50.7,5124821,5124821,2493916,48.7,2630905,51.3,180641,2.7,6511237,97.3,5703463,85.2,739547,11.1,48290,0.7,193559,2.9,11281,0.2,191174,2.9
2018,Iowa,3156145,1564888,49.6,1591257,50.4,2422756,2422756,1188114,49,1234642,51,69268,2.2,3086877,97.8,2909568,92.2,151562,4.8,27116,0.9,98900,3.1,6579,0.2,37007,1.2
2018,Kansas,2911510,1449745,49.8,1461765,50.2,2206359,2206359,1090789,49.4,1115570,50.6,108051,3.7,2803459,96.3,2544721,87.4,218001,7.5,64801,2.2,107317,3.7,8989,0.3,83074,2.9
2018,Kentucky,4468402,2199021,49.2,2269381,50.8,3460621,3460621,1681046,48.6,1779575,51.4,108018,2.4,4360384,97.6,3974518,88.9,422416,9.5,29444,0.7,87095,1.9,9563,0.2,62137,1.4
2018,Louisiana,4659978,2276530,48.9,2383448,51.1,3562393,3562393,1712995,48.1,1849398,51.9,105045,2.3,4554933,97.7,2966465,63.7,1565302,33.6,58123,1.2,101220,2.2,6181,0.1,75404,1.6
2018,Maine,1338404,655734,49,682670,51,1089852,1089852,527338,48.4,562514,51.6,30019,2.2,1308385,97.8,1289950,96.4,27637,2.1,22607,1.7,23286,1.7,1880,0.1,5459,0.4
2018,Maryland,6042718,2930350,48.5,3112368,51.5,4704363,4704363,2246001,47.7,2458362,52.3,223015,3.7,5819703,96.3,3489566,57.7,1932303,32,60221,1,459537,7.6,15994,0.3,335682,5.6
2018,Massachusetts,6902149,3350887,48.5,3551262,51.5,5535023,5535023,2652764,47.9,2882259,52.1,234744,3.4,6667405,96.6,5538925,80.2,666025,9.6,52093,0.8,540441,7.8,8234,0.1,348753,5.1
2018,Michigan,9995915,4926816,49.3,5069099,50.7,7831650,7831650,3817463,48.7,4014187,51.3,292665,2.9,9703250,97.1,8092824,81,1519646,15.2,146197,1.5,393744,3.9,11157,0.1,145988,1.5
2018,Minnesota,5611179,2793980,49.8,2817199,50.2,4309132,4309132,2127007,49.4,2182125,50.6,174832,3.1,5436347,96.9,4787851,85.3,445288,7.9,112850,2,328249,5.8,7964,0.1,118258,2.1
2018,Mississippi,2986530,1446829,48.4,1539701,51.6,2280808,2280808,1085780,47.6,1195028,52.4,44950,1.5,2941580,98.5,1776445,59.5,1161529,38.9,20404,0.7,38212,1.3,4583,0.2,33358,1.1
2018,Missouri,6126452,3003165,49,3123287,51,4748726,4748726,2298091,48.4,2450635,51.6,173864,2.8,5952588,97.2,5196815,84.8,794984,13,79954,1.3,159166,2.6,13760,0.2,66685,1.1
2018,Montana,1062305,534782,50.3,527523,49.7,832340,832340,416551,50,415789,50,32463,3.1,1029842,96.9,972128,91.5,9491,0.9,87853,8.3,15317,1.4,2773,0.3,8847,0.8
2018,Nebraska,1929268,961213,49.8,968055,50.2,1454382,1454382,717855,49.4,736527,50.6,58961,3.1,1870307,96.9,1720346,89.2,114414,5.9,35790,1.9,63282,3.3,3142,0.2,55747,2.9
2018,Nevada,3034392,1522374,50.2,1512018,49.8,2345172,2345172,1169070,49.9,1176102,50.1,155830,5.1,2878562,94.9,2050048,67.6,337660,11.1,71817,2.4,318010,10.5,41746,1.4,390057,12.9
2018,New Hampshire,1356458,669442,49.4,687016,50.6,1098330,1098330,539550,49.1,558780,50.9,29957,2.2,1326501,97.8,1282576,94.6,34419,2.5,11622,0.9,46745,3.4,1884,0.1,11005,0.8
2018,New Jersey,8908520,4350386,48.8,4558134,51.2,6957515,6957515,3357645,48.3,3599870,51.7,247399,2.8,8661121,97.2,6154690,69.1,1335579,15,56649,0.6,956049,10.7,11641,0.1,664813,7.5
2018,New Mexico,2095428,1039641,49.6,1055787,50.4,1615191,1615191,793301,49.1,821890,50.9,67186,3.2,2028242,96.8,1658939,79.2,61079,2.9,226911,10.8,47195,2.3,4997,0.2,168030,8
2018,New York,19542209,9491313,48.6,10050896,51.4,15477524,15477524,7411537,47.9,8065987,52.1,647655,3.3,18894554,96.7,12879039,65.9,3396032,17.4,207373,1.1,1879261,9.6,30852,0.2,1854260,9.5
2018,North Carolina,10383620,5052244,48.7,5331376,51.3,8086762,8086762,3875167,47.9,4211595,52.1,298143,2.9,10085477,97.1,7347405,70.8,2398801,23.1,205652,2,376535,3.6,24349,0.2,358550,3.5
2018,North Dakota,760077,391222,51.5,368855,48.5,585363,585363,299924,51.2,285439,48.8,17567,2.3,742510,97.7,668212,87.9,29988,3.9,50434,6.6,18212,2.4,1168,0.2,11370,1.5
2018,Ohio,11689442,5732095,49,5957347,51,9099006,9099006,4405595,48.4,4693411,51.6,358398,3.1,11331044,96.9,9794421,83.8,1674699,14.3,104484,0.9,345724,3,13486,0.1,141318,1.2
2018,Oklahoma,3943079,1950076,49.5,1993003,50.5,2986759,2986759,1462478,49,1524281,51,303744,7.7,3639335,92.3,3124653,79.2,365013,9.3,533348,13.5,111634,2.8,8929,0.2,126533,3.2
2018,Oregon,4190713,2079943,49.6,2110770,50.4,3318125,3318125,1632062,49.2,1686063,50.8,197222,4.7,3993491,95.3,3697861,88.2,122063,2.9,124112,3,257861,6.2,33831,0.8,165867,4
2018,Pennsylvania,12807060,6271620,49,6535440,51,10159443,10159443,4919474,48.4,5239969,51.6,333545,2.6,12473515,97.4,10543254,82.3,1632035,12.7,89728,0.7,536235,4.2,18764,0.1,355417,2.8
2018,Puerto Rico,3195153,1520415,47.6,1674738,52.4,2601143,2601143,1215558,46.7,1385585,53.3,153216,4.8,3041937,95.2,2225568,69.7,544587,17,11722,0.4,6884,0.2,1245,0,564119,17.7
2018,Rhode Island,1057315,515900,48.8,541415,51.2,853407,853407,410324,48.1,443083,51.9,32730,3.1,1024585,96.9,881270,83.3,86469,8.2,11871,1.1,45191,4.3,2378,0.2,65845,6.2
2018,South Carolina,5084127,2468707,48.6,2615420,51.4,3979718,3979718,1899602,47.7,2080116,52.3,121197,2.4,4962930,97.6,3511420,69.1,1423790,28,53066,1,107491,2.1,9865,0.2,111572,2.2
2018,South Dakota,882235,445271,50.5,436964,49.5,667772,667772,334365,50.1,333407,49.9,23384,2.7,858851,97.3,763432,86.5,26781,3,92049,10.4,17534,2,819,0.1,6550,0.7
2018,Tennessee,6770010,3302191,48.8,3467819,51.2,5260635,5260635,2527405,48,2733230,52,151792,2.2,6618218,97.8,5373382,79.4,1217973,18,55944,0.8,155876,2.3,12962,0.2,115232,1.7
2018,Texas,28701845,14250184,49.6,14451661,50.4,21302361,21302361,10473771,49.2,10828590,50.8,763990,2.7,27937855,97.3,21759347,75.8,3827321,13.3,351369,1.2,1648133,5.7,61344,0.2,1878367,6.5
2018,Utah,3161105,1592457,50.4,1568648,49.6,2229274,2229274,1113904,50,1115370,50,101151,3.2,3059954,96.8,2800377,88.6,58241,1.8,56454,1.8,115638,3.7,47609,1.5,191869,6.1
2018,Vermont,626299,308118,49.2,318181,50.8,510772,510772,249177,48.8,261595,51.2,12785,2,613514,98,600494,95.9,12187,1.9,7315,1.2,15706,2.5,806,0.1,3240,0.5
2018,Virginia,8517685,4190738,49.2,4326947,50.8,6648045,6648045,3232257,48.6,3415788,51.4,349504,4.1,8168181,95.9,6043577,71,1807434,21.2,90683,1.1,688297,8.1,19169,0.2,253957,3
2018,Washington,7535591,3766859,50,3768732,50,5873652,5873652,2920360,49.7,2953292,50.3,452633,6,7082958,94,6041370,80.2,422547,5.6,226088,3,857031,11.4,95373,1.3,398348,5.3
2018,West Virginia,1805832,894657,49.5,911175,50.5,1442607,1442607,707039,49,735568,51,34411,1.9,1771421,98.1,1712618,94.8,89894,5,9599,0.5,19875,1.1,2577,0.1,8067,0.4
2018,Wisconsin,5813568,2891282,49.7,2922286,50.3,4541463,4541463,2240074,49.3,2301389,50.7,146513,2.5,5667055,97.5,5091797,87.6,440836,7.6,90189,1.6,201356,3.5,5350,0.1,139088,2.4
2018,Wyoming,577737,292619,50.6,285118,49.4,444641,444641,224675,50.5,219966,49.5,13716,2.4,564021,97.6,541280,93.7,8296,1.4,21867,3.8,8317,1.4,1347,0.2,10603,1.8
2019,Alabama,4903185,2369611,48.3,2533574,51.7,3817588,3817588,1812854,47.5,2004734,52.5,91522,1.9,4811663,98.1,3409415,69.5,1364474,27.8,53674,1.1,87434,1.8,5386,0.1,81472,1.7
2019,Alaska,731545,380433,52,351112,48,551796,551796,287256,52.1,264540,47.9,57476,7.9,674069,92.1,521962,71.4,34639,4.7,147358,20.1,61551,8.4,13352,1.8,15700,2.1
2019,Arizona,7278717,3620935,49.7,3657782,50.3,5639069,5639069,2782081,49.3,2856988,50.7,280574,3.9,6998143,96.1,5947783,81.7,434612,6,412256,5.7,331649,4.6,31725,0.4,422541,5.8
2019,Arkansas,3017804,1474705,48.9,1543099,51.1,2318792,2318792,1119340,48.3,1199452,51.7,83603,2.8,2934201,97.2,2391900,79.3,502913,16.7,54059,1.8,59114,2,14051,0.5,82974,2.7
2019,California,39512223,19640794,49.7,19871429,50.3,30621159,30621159,15100913,49.3,15520246,50.7,1978145,5,37534078,95,25133071,63.6,2782446,7,772394,2,6762404,17.1,334351,0.8,5895002,14.9
2019,Colorado,5758736,2904955,50.4,2853781,49.6,4502416,4502416,2259424,50.2,2242992,49.8,232943,4,5525793,96,5029314,87.3,313737,5.4,135472,2.4,263806,4.6,23731,0.4,248621,4.3
2019,Connecticut,3565287,1743777,48.9,1821510,51.1,2837855,2837855,1370524,48.3,1467331,51.7,131068,3.7,3434219,96.3,2772139,77.8,470791,13.2,36229,1,198207,5.6,4377,0.1,228411,6.4
2019,Delaware,973764,470288,48.3,503476,51.7,769818,769818,366941,47.7,402877,52.3,30167,3.1,943597,96.9,686096,70.5,237780,24.4,9307,1,45365,4.7,1252,0.1,26576,2.7
2019,Florida,21477737,10498005,48.9,10979732,51.1,17245782,17245782,8334993,48.3,8910789,51.7,631552,2.9,20846185,97.1,16553934,77.1,3772874,17.6,174845,0.8,787637,3.7,45992,0.2,828037,3.9
2019,Georgia,10617423,5170126,48.7,5447297,51.3,8114394,8114394,3879247,47.8,4235147,52.2,284421,2.7,10333002,97.3,6363129,59.9,3556697,33.5,91801,0.9,523612,4.9,17766,0.2,368840,3.5
2019,Hawaii,1415872,707855,50,708017,50,1115685,1115685,553276,49.6,562409,50.4,316468,22.4,1099404,77.6,582436,41.1,49041,3.5,31936,2.3,801987,56.6,354987,25.1,44491,3.1
2019,Idaho,1787065,898044,50.3,889021,49.7,1337710,1337710,667208,49.9,670502,50.1,58700,3.3,1728365,96.7,1652946,92.5,21666,1.2,43756,2.4,44416,2.5,7130,0.4,80118,4.5
2019,Illinois,12671821,6217305,49.1,6454516,50.9,9857142,9857142,4784829,48.5,5072313,51.5,351933,2.8,12319888,97.2,9353507,73.8,1951681,15.4,101823,0.8,834455,6.6,16155,0.1,796594,6.3
2019,Indiana,6732219,3319907,49.3,3412312,50.7,5164798,5164798,2513202,48.7,2651596,51.3,174283,2.6,6557936,97.4,5732778,85.2,740150,11,53972,0.8,206288,3.1,8652,0.1,175969,2.6
2019,Iowa,3155070,1570384,49.8,1584686,50.2,2433240,2433240,1199888,49.3,1233352,50.7,68248,2.2,3086822,97.8,2900114,91.9,162710,5.2,24157,0.8,95994,3,5051,0.2,39087,1.2
2019,Kansas,2913314,1446287,49.6,1467027,50.4,2213013,2213013,1090733,49.3,1122280,50.7,108771,3.7,2804543,96.3,2537764,87.1,214714,7.4,66174,2.3,108624,3.7,5752,0.2,97606,3.4
2019,Kentucky,4467673,2198205,49.2,2269468,50.8,3465848,3465848,1683676,48.6,1782172,51.4,104158,2.3,4363515,97.7,3971124,88.9,424716,9.5,27768,0.6,94285,2.1,6874,0.2,53286,1.2
2019,Louisiana,4648794,2268202,48.8,2380592,51.2,3563908,3563908,1709791,48,1854117,52,93067,2,4555727,98,2954143,63.5,1554297,33.4,62087,1.3,99072,2.1,4313,0.1,76113,1.6
2019,Maine,1344212,656330,48.8,687882,51.2,1097859,1097859,530772,48.3,567087,51.7,28536,2.1,1315676,97.9,1289759,95.9,32313,2.4,21048,1.6,23516,1.7,1177,0.1,7973,0.6
2019,Maryland,6045680,2928013,48.4,3117667,51.6,4713393,4713393,2249586,47.7,2463807,52.3,205558,3.4,5840122,96.6,3467089,57.3,1946932,32.2,55949,0.9,463258,7.7,10564,0.2,328213,5.4
2019,Massachusetts,6892503,3345556,48.5,3546947,51.5,5540726,5540726,2654903,47.9,2885823,52.1,250459,3.6,6642044,96.4,5525268,80.2,684786,9.9,50888,0.7,548125,8,9306,0.1,340401,4.9
2019,Michigan,9986857,4915905,49.2,5070952,50.8,7844035,7844035,3820907,48.7,4023128,51.3,302340,3,9684517,97,8091386,81,1528779,15.3,149052,1.5,394895,4,8522,0.1,140058,1.4
2019,Minnesota,5639632,2804216,49.7,2835416,50.3,4336963,4336963,2139845,49.3,2197118,50.7,186583,3.3,5453049,96.7,4800334,85.1,454116,8.1,114350,2,333624,5.9,9728,0.2,128643,2.3
2019,Mississippi,2976149,1434957,48.2,1541192,51.8,2277729,2277729,1083089,47.6,1194640,52.4,43664,1.5,2932485,98.5,1766642,59.4,1156497,38.9,25154,0.8,40448,1.4,1638,0.1,31875,1.1
2019,Missouri,6137428,3008169,49,3129259,51,4764733,4764733,2305849,48.4,2458884,51.6,172253,2.8,5965175,97.2,5184435,84.5,792197,12.9,77887,1.3,162980,2.7,15817,0.3,89385,1.5
2019,Montana,1068778,537170,50.3,531608,49.7,842254,842254,420243,49.9,422011,50.1,36517,3.4,1032261,96.6,973711,91.1,14608,1.4,90259,8.4,17354,1.6,4170,0.4,10226,1
2019,Nebraska,1934408,966650,50,967758,50,1459312,1459312,721812,49.5,737500,50.5,53383,2.8,1881025,97.2,1715918,88.7,117408,6.1,34247,1.8,62532,3.2,4380,0.2,58108,3
2019,Nevada,3080156,1544779,50.2,1535377,49.8,2389419,2389419,1191972,49.9,1197447,50.1,144208,4.7,2935948,95.3,2105913,68.4,347489,11.3,69491,2.3,323433,10.5,42865,1.4,349520,11.3
2019,New Hampshire,1359711,672960,49.5,686751,50.5,1103691,1103691,542357,49.1,561334,50.9,30205,2.2,1329506,97.8,1287518,94.7,30557,2.2,11586,0.9,47854,3.5,2440,0.2,12038,0.9
2019,New Jersey,8882190,4342591,48.9,4539599,51.1,6944166,6944166,3351015,48.3,3593151,51.7,264429,3,8617761,97,6174937,69.5,1339574,15.1,57278,0.6,953119,10.7,11855,0.1,633898,7.1
2019,New Mexico,2096829,1036708,49.4,1060121,50.6,1622979,1622979,794464,49,828515,51,72444,3.5,2024385,96.5,1610185,76.8,70254,3.4,226281,10.8,53384,2.5,4029,0.2,211040,10.1
2019,New York,19453561,9450810,48.6,10002751,51.4,15431465,15431465,7388570,47.9,8042895,52.1,649298,3.3,18804263,96.7,12796656,65.8,3424002,17.6,196234,1,1889234,9.7,32965,0.2,1826106,9.4
2019,North Carolina,10488084,5094327,48.6,5393757,51.4,8194112,8194112,3922178,47.9,4271934,52.1,295137,2.8,10192947,97.2,7393223,70.5,2424132,23.1,208829,2,382201,3.6,18026,0.2,387557,3.7
2019,North Dakota,762062,388339,51,373723,49,585356,585356,298181,50.9,287175,49.1,25145,3.3,736917,96.7,677907,89,30067,3.9,52745,6.9,16308,2.1,3073,0.4,7959,1
2019,Ohio,11689100,5732207,49,5956893,51,9114253,9114253,4411835,48.4,4702418,51.6,343341,2.9,11345759,97.1,9765556,83.5,1686729,14.4,97330,0.8,348025,3,17557,0.2,148342,1.3
2019,Oklahoma,3956971,1962477,49.6,1994494,50.4,3004742,3004742,1470313,48.9,1534429,51.1,300165,7.6,3656806,92.4,3135648,79.2,365883,9.2,540542,13.7,114316,2.9,12902,0.3,106233,2.7
2019,Oregon,4217737,2089676,49.5,2128061,50.5,3354921,3354921,1647172,49.1,1707749,50.9,207325,4.9,4010412,95.1,3717165,88.1,124502,3,129081,3.1,263017,6.2,35802,0.8,175072,4.2
2019,Pennsylvania,12801989,6272527,49,6529462,51,10169664,10169664,4925483,48.4,5244181,51.6,332708,2.6,12469281,97.4,10483806,81.9,1649737,12.9,92251,0.7,536892,4.2,14490,0.1,386035,3
2019,Puerto Rico,3193694,1515994,47.5,1677700,52.5,2620960,2620960,1224344,46.7,1396616,53.3,227090,7.1,2966604,92.9,2275620,71.3,609279,19.1,13738,0.4,8734,0.3,349,0,522308,16.4
2019,Rhode Island,1059361,517221,48.8,542140,51.2,855786,855786,412642,48.2,443144,51.8,44600,4.2,1014761,95.8,869057,82,101579,9.6,13827,1.3,48037,4.5,3288,0.3,73269,6.9
2019,South Carolina,5148714,2485001,48.3,2663713,51.7,4036414,4036414,1922777,47.6,2113637,52.4,125531,2.4,5023183,97.6,3544015,68.8,1441530,28,47908,0.9,111414,2.2,12744,0.2,127224,2.5
2019,South Dakota,884659,449458,50.8,435201,49.2,669390,669390,335932,50.2,333458,49.8,24698,2.8,859961,97.2,766781,86.7,26679,3,92709,10.5,14395,1.6,2868,0.3,6973,0.8
2019,Tennessee,6829174,3329115,48.7,3500059,51.3,5318422,5318422,2554545,48,2763877,52,156246,2.3,6672928,97.7,5413418,79.3,1228973,18,58662,0.9,164002,2.4,9899,0.1,123704,1.8
2019,Texas,28995881,14385762,49.6,14610119,50.4,21599250,21599250,10618690,49.2,10980560,50.8,835927,2.9,28159954,97.1,21995420,75.9,3908287,13.5,350100,1.2,1678495,5.8,68085,0.2,1898004,6.5
2019,Utah,3205958,1610671,50.2,1595287,49.8,2275650,2275650,1134329,49.8,1141321,50.2,103574,3.2,3102384,96.8,2893306,90.2,61766,1.9,57986,1.8,118169,3.7,49776,1.6,142626,4.4
2019,Vermont,623989,309164,49.5,314825,50.5,510430,510430,250316,49,260114,51,15367,2.5,608622,97.5,600353,96.2,13042,2.1,9006,1.4,15149,2.4,608,0.1,2504,0.4
2019,Virginia,8535519,4201799,49.2,4333720,50.8,6677914,6677914,3246462,48.6,3431452,51.4,320232,3.8,8215287,96.2,5994267,70.2,1820891,21.3,76902,0.9,690204,8.1,16638,0.2,283087,3.3
2019,Washington,7614893,3807572,50,3807321,50,5951928,5951928,2958683,49.7,2993245,50.3,453495,6,7161398,94,6056387,79.5,429718,5.6,228712,3,883108,11.6,100352,1.3,419447,5.5
2019,West Virginia,1792147,885861,49.4,906286,50.6,1433329,1433329,702698,49,730631,51,32250,1.8,1759897,98.2,1697080,94.7,86426,4.8,11575,0.6,20033,1.1,1710,0.1,9790,0.5
2019,Wisconsin,5822434,2892804,49.7,2929630,50.3,4559022,4559022,2247843,49.3,2311179,50.7,137034,2.4,5685400,97.6,5088607,87.4,438719,7.5,92246,1.6,201512,3.5,7925,0.1,139326,2.4
2019,Wyoming,578759,296005,51.1,282754,48.9,444570,444570,226129,50.9,218441,49.1,15823,2.7,562936,97.3,540317,93.4,12428,2.1,19199,3.3,8673,1.5,2060,0.4,14143,2.4